Font: courB24 (Latin-1-bdf-sources/courB24.bdf)
Declared name: -Adobe-Courier-Bold-R-Normal--34-240-100-100-M-200-ISO10646-1
Declared family: courier
Declared weight: bold
Declared size: 34
Matching characters: 15
Height: 21
Baseline: 21
Max width: 20
Fixed width: True

Char: 32 (space), width: 20
  .                    .
  .                    .
  .                    .
  .                    .
  .                    .
  .                    .
  .                    .
  .                    .
  .                    .
  .                    .
  .                    .
  .                    .
  .                    .
  .                    .
  .                    .
  .                    .
  .                    .
  .                    .
  .                    .
  .                    .
  _                    _

Char: 43 (plus), width: 20
  .                    .
  .                    .
  .                    .
  .        ###         .
  .        ###         .
  .        ###         .
  .        ###         .
  .        ###         .
  .        ###         .
  .        ###         .
  . #################  .
  . #################  .
  . #################  .
  .        ###         .
  .        ###         .
  .        ###         .
  .        ###         .
  .        ###         .
  .        ###         .
  .        ###         .
  _                    _

Char: 45 (hyphen), width: 20
  .                    .
  .                    .
  .                    .
  .                    .
  .                    .
  .                    .
  .                    .
  .                    .
  .                    .
  .                    .
  .  ###############   .
  .  ###############   .
  .  ###############   .
  .                    .
  .                    .
  .                    .
  .                    .
  .                    .
  .                    .
  .                    .
  _                    _

Char: 46 (period), width: 20
  .                    .
  .                    .
  .                    .
  .                    .
  .                    .
  .                    .
  .                    .
  .                    .
  .                    .
  .                    .
  .                    .
  .                    .
  .                    .
  .                    .
  .                    .
  .                    .
  .                    .
  .        ###         .
  .       #####        .
  .       #####        .
  _        ###         _

Char: 48 (zero), width: 20
  .       #####        .
  .     #########      .
  .    ###########     .
  .    ###     ###     .
  .   ####     ####    .
  .   ###       ###    .
  .   ###       ###    .
  .   ###       ###    .
  .   ###       ###    .
  .   ###       ###    .
  .   ###       ###    .
  .   ###       ###    .
  .   ###       ###    .
  .   ###       ###    .
  .   ###       ###    .
  .   ###       ###    .
  .   ####     ####    .
  .    ###     ###     .
  .    ###########     .
  .     #########      .
  _       #####        _

Char: 49 (one), width: 20
  .         ##         .
  .       ####         .
  .    #######         .
  .   ########         .
  .   ########         .
  .    ##  ###         .
  .        ###         .
  .        ###         .
  .        ###         .
  .        ###         .
  .        ###         .
  .        ###         .
  .        ###         .
  .        ###         .
  .        ###         .
  .        ###         .
  .        ###         .
  .        ###         .
  .   #############    .
  .   #############    .
  _   #############    _

Char: 50 (two), width: 20
  .        #####       .
  .      #########     .
  .     ###########    .
  .    ####     ####   .
  .    ###       ###   .
  .    ###       ###   .
  .    ###       ###   .
  .              ###   .
  .             ###    .
  .            ####    .
  .           ####     .
  .          ####      .
  .         ####       .
  .        ####        .
  .       ####         .
  .      ####          .
  .     ####           .
  .    ####            .
  .   ##############   .
  .   ##############   .
  _   ##############   _

Char: 51 (three), width: 20
  .       ######       .
  .     #########      .
  .   ############     .
  .   ####     ####    .
  .   ###       ###    .
  .             ###    .
  .             ###    .
  .            ####    .
  .       ########     .
  .       #######      .
  .       ########     .
  .           #####    .
  .             ###    .
  .              ###   .
  .              ###   .
  .              ###   .
  .             ####   .
  .  ###       ####    .
  .  ##############    .
  .  #############     .
  _    #########       _

Char: 52 (four), width: 20
  .           ####     .
  .          #####     .
  .          #####     .
  .         ######     .
  .        #######     .
  .        ### ###     .
  .       #### ###     .
  .       ###  ###     .
  .      ####  ###     .
  .      ###   ###     .
  .     ###    ###     .
  .    ####    ###     .
  .    ###     ###     .
  .   ##############   .
  .   ##############   .
  .   ##############   .
  .            ###     .
  .            ###     .
  .         ########   .
  .         ########   .
  _         ########   _

Char: 53 (five), width: 20
  .    ############    .
  .    ############    .
  .    ############    .
  .    ###             .
  .    ###             .
  .    ###             .
  .    ###             .
  .    #########       .
  .    ###########     .
  .    ############    .
  .    ###    #####    .
  .             ####   .
  .              ###   .
  .              ###   .
  .              ###   .
  .              ###   .
  .   #         ####   .
  .  ####      ####    .
  .  #############     .
  .   ############     .
  _     ########       _

Char: 54 (six), width: 20
  .          ######    .
  .        ########    .
  .       #########    .
  .      #####         .
  .     ####           .
  .    ####            .
  .    ###             .
  .    ###             .
  .   ###   ####       .
  .   ### ########     .
  .   ############     .
  .   #####    ####    .
  .   ####      ####   .
  .   ###        ###   .
  .   ###        ###   .
  .   ####       ###   .
  .    ###      ####   .
  .    ####    ####    .
  .    ############    .
  .     ##########     .
  _       ######       _

Char: 55 (seven), width: 20
  .   ##############   .
  .   ##############   .
  .   ##############   .
  .   ###       ####   .
  .   ###       ###    .
  .   ###       ###    .
  .             ###    .
  .            ####    .
  .            ###     .
  .            ###     .
  .           ####     .
  .           ###      .
  .           ###      .
  .          ####      .
  .          ###       .
  .          ###       .
  .         ####       .
  .         ###        .
  .        ####        .
  .        ###         .
  _        ###         _

Char: 56 (eight), width: 20
  .       #####        .
  .     #########      .
  .    ###########     .
  .    ###     ###     .
  .   ###       ###    .
  .   ###       ###    .
  .   ###       ###    .
  .    ###     ###     .
  .    ###########     .
  .     #########      .
  .     ##########     .
  .    #####  #####    .
  .   ####      ####   .
  .   ###        ###   .
  .   ###        ###   .
  .   ###        ###   .
  .   ###        ###   .
  .   #####    #####   .
  .    ############    .
  .     ##########     .
  _       ######       _

Char: 57 (nine), width: 20
  .       #####        .
  .     #########      .
  .    ###########     .
  .    ####   ####     .
  .   ####     ####    .
  .   ###       ###    .
  .   ###       ####   .
  .   ###       ####   .
  .   ###       ####   .
  .   ####     #####   .
  .    ####   ######   .
  .     ######## ###   .
  .     #######  ###   .
  .       ####  ####   .
  .             ###    .
  .            ####    .
  .            ###     .
  .    ##    #####     .
  .   ###########      .
  .   #########        .
  _    ######          _

Char: 58 (colon), width: 20
  .                    .
  .                    .
  .                    .
  .                    .
  .                    .
  .                    .
  .        ###         .
  .       #####        .
  .       #####        .
  .        ###         .
  .                    .
  .                    .
  .                    .
  .                    .
  .                    .
  .                    .
  .                    .
  .        ###         .
  .       #####        .
  .       #####        .
  _        ###         _
