Font: courR14 (Latin-1-bdf-sources/courR14.bdf)
Declared name: -adobe-courier-medium-r-normal--20-140-100-100-m-110-iso10646-1
Declared family: courier
Declared weight: medium
Declared size: 20
Characters: 15
Height: 12
Baseline: 12
Max width: 11
Fixed width: True

Char 32 (space), width 11
  .           . 
  .           . 
  .           . 
  .           . 
  .           . 
  .           . 
  .           . 
  .           . 
  .           . 
  .           . 
  .           . 
 __           __

Char 43 (plus), width 11
  .           . 
  .           . 
  .     #     . 
  .     #     . 
  .     #     . 
  .     #     . 
  . ######### . 
  .     #     . 
  .     #     . 
  .     #     . 
  .     #     . 
 __           __

Char 45 (hyphen), width 11
  .           . 
  .           . 
  .           . 
  .           . 
  .           . 
  .           . 
  . ########  . 
  .           . 
  .           . 
  .           . 
  .           . 
 __           __

Char 46 (period), width 11
  .           . 
  .           . 
  .           . 
  .           . 
  .           . 
  .           . 
  .           . 
  .           . 
  .           . 
  .           . 
  .    ##     . 
 __    ##     __

Char 48 (zero), width 11
  .    ###    . 
  .   #   #   . 
  .  #     #  . 
  .  #     #  . 
  .  #     #  . 
  .  #     #  . 
  .  #     #  . 
  .  #     #  . 
  .  #     #  . 
  .  #     #  . 
  .   #   #   . 
 __    ###    __

Char 49 (one), width 11
  .    ##     . 
  .  ## #     . 
  .     #     . 
  .     #     . 
  .     #     . 
  .     #     . 
  .     #     . 
  .     #     . 
  .     #     . 
  .     #     . 
  .     #     . 
 __  #######  __

Char 50 (two), width 11
  .    ###    . 
  .   #   #   . 
  .  #     #  . 
  .  #     #  . 
  .        #  . 
  .       #   . 
  .      #    . 
  .     #     . 
  .    #      . 
  .   #    #  . 
  .  #     #  . 
 __ ########  __

Char 51 (three), width 11
  .   ####    . 
  .  #    #   . 
  .        #  . 
  .        #  . 
  .       #   . 
  .    ###    . 
  .       #   . 
  .        #  . 
  .        #  . 
  .        #  . 
  .  #    #   . 
 __   ####    __

Char 52 (four), width 11
  .      ##   . 
  .     # #   . 
  .     # #   . 
  .    #  #   . 
  .    #  #   . 
  .   #   #   . 
  .   #   #   . 
  .  #    #   . 
  .  #######  . 
  .       #   . 
  .       #   . 
 __     ####  __

Char 53 (five), width 11
  .  ######   . 
  .  #        . 
  .  #        . 
  .  #        . 
  .  # ###    . 
  .  ##   #   . 
  .        #  . 
  .        #  . 
  .        #  . 
  .        #  . 
  . ##    #   . 
 __   ####    __

Char 54 (six), width 11
  .     ###   . 
  .   ##      . 
  .   #       . 
  .  #        . 
  .  #        . 
  .  # ###    . 
  .  ##   #   . 
  .  #     #  . 
  .  #     #  . 
  .  #     #  . 
  .   #   #   . 
 __    ###    __

Char 55 (seven), width 11
  .  #######  . 
  .  #     #  . 
  .        #  . 
  .        #  . 
  .       #   . 
  .       #   . 
  .       #   . 
  .       #   . 
  .      #    . 
  .      #    . 
  .      #    . 
 __      #    __

Char 56 (eight), width 11
  .    ###    . 
  .   #   #   . 
  .  #     #  . 
  .  #     #  . 
  .   #   #   . 
  .    ###    . 
  .   #   #   . 
  .  #     #  . 
  .  #     #  . 
  .  #     #  . 
  .   #   #   . 
 __    ###    __

Char 57 (nine), width 11
  .    ###    . 
  .   #   #   . 
  .  #     #  . 
  .  #     #  . 
  .  #     #  . 
  .   #   ##  . 
  .    ### #  . 
  .        #  . 
  .        #  . 
  .       #   . 
  .      ##   . 
 __   ###     __

Char 58 (colon), width 11
  .           . 
  .           . 
  .           . 
  .           . 
  .    ##     . 
  .    ##     . 
  .           . 
  .           . 
  .           . 
  .           . 
  .    ##     . 
 __    ##     __
