Font: courB18 (Latin-1-bdf-sources/courB18.bdf)
Declared name: -adobe-courier-bold-r-normal--25-180-100-100-m-150-iso10646-1
Declared family: courier
Declared weight: bold
Declared size: 25
Characters: 15
Height: 16
Baseline: 16
Max width: 15
Fixed width: True

Char 32 (space), width 15
  .               . 
  .               . 
  .               . 
  .               . 
  .               . 
  .               . 
  .               . 
  .               . 
  .               . 
  .               . 
  .               . 
  .               . 
  .               . 
  .               . 
  .               . 
  .               . 

Char 43 (plus), width 15
  .               . 
  .               . 
  .               . 
  .      ##       . 
  .      ##       . 
  .      ##       . 
  .      ##       . 
  .      ##       . 
  . ############  . 
  . ############  . 
  .      ##       . 
  .      ##       . 
  .      ##       . 
  .      ##       . 
  .      ##       . 
  .               . 

Char 45 (hyphen), width 15
  .               . 
  .               . 
  .               . 
  .               . 
  .               . 
  .               . 
  .               . 
  .               . 
  .  ###########  . 
  .  ###########  . 
  .               . 
  .               . 
  .               . 
  .               . 
  .               . 
  .               . 

Char 46 (period), width 15
  .               . 
  .               . 
  .               . 
  .               . 
  .               . 
  .               . 
  .               . 
  .               . 
  .               . 
  .               . 
  .               . 
  .               . 
  .               . 
  .     ###       . 
  .     ###       . 
  .     ###       . 

Char 48 (zero), width 15
  .     ####      . 
  .   ########    . 
  .   ##    ##    . 
  .  ##      ##   . 
  .  ##      ##   . 
  .  ##      ##   . 
  .  ##      ##   . 
  .  ##      ##   . 
  .  ##      ##   . 
  .  ##      ##   . 
  .  ##      ##   . 
  .  ##      ##   . 
  .  ##      ##   . 
  .   ##    ##    . 
  .   ########    . 
  .     ####      . 

Char 49 (one), width 15
  .     ###       . 
  .  ######       . 
  .  ######       . 
  .      ##       . 
  .      ##       . 
  .      ##       . 
  .      ##       . 
  .      ##       . 
  .      ##       . 
  .      ##       . 
  .      ##       . 
  .      ##       . 
  .      ##       . 
  .      ##       . 
  .  ##########   . 
  .  ##########   . 

Char 50 (two), width 15
  .    ######     . 
  .   ########    . 
  .  ###    ###   . 
  .  ##      ##   . 
  .  ##      ##   . 
  .          ##   . 
  .         ###   . 
  .        ###    . 
  .       ###     . 
  .      ###      . 
  .     ###       . 
  .    ###        . 
  .   ###         . 
  .  ###          . 
  . ###########   . 
  . ###########   . 

Char 51 (three), width 15
  .    ######     . 
  .   ########    . 
  .  ###    ###   . 
  .  ##      ##   . 
  .          ##   . 
  .         ###   . 
  .        ###    . 
  .     #####     . 
  .     ######    . 
  .         ###   . 
  .          ##   . 
  .          ##   . 
  . ##       ##   . 
  . ###     ###   . 
  .  #########    . 
  .   #######     . 

Char 52 (four), width 15
  .       ###     . 
  .      ####     . 
  .     #####     . 
  .     ## ##     . 
  .    ##  ##     . 
  .    ##  ##     . 
  .   ##   ##     . 
  .   ##   ##     . 
  .  ##    ##     . 
  .  ##    ##     . 
  . ###########   . 
  . ###########   . 
  .        ##     . 
  .        ##     . 
  .     #######   . 
  .     #######   . 

Char 53 (five), width 15
  .   #########   . 
  .   #########   . 
  .   ##          . 
  .   ##          . 
  .   ##          . 
  .   ## ####     . 
  .   #########   . 
  .   ###   ###   . 
  .          ###  . 
  .           ##  . 
  .           ##  . 
  .           ##  . 
  .  ##      ###  . 
  .  ###    ###   . 
  .   #########   . 
  .    ######     . 

Char 54 (six), width 15
  .       #####   . 
  .     #######   . 
  .    ####       . 
  .   ###         . 
  .   ##          . 
  .  ###          . 
  .  ## #####     . 
  .  #########    . 
  .  ###    ###   . 
  .  ##      ##   . 
  .  ##      ##   . 
  .  ##      ##   . 
  .  ###     ##   . 
  .   ###   ###   . 
  .   ########    . 
  .     #####     . 

Char 55 (seven), width 15
  .  ##########   . 
  .  ##########   . 
  .  ##      ##   . 
  .          ##   . 
  .         ##    . 
  .         ##    . 
  .         ##    . 
  .        ##     . 
  .        ##     . 
  .        ##     . 
  .       ##      . 
  .       ##      . 
  .       ##      . 
  .      ##       . 
  .      ##       . 
  .      ##       . 

Char 56 (eight), width 15
  .     ####      . 
  .   ########    . 
  .  ###    ###   . 
  .  ##      ##   . 
  .  ##      ##   . 
  .  ##      ##   . 
  .   ##    ##    . 
  .    ######     . 
  .   ########    . 
  .  ###    ###   . 
  .  ##      ##   . 
  .  ##      ##   . 
  .  ##      ##   . 
  .  ###    ###   . 
  .   ########    . 
  .    ######     . 

Char 57 (nine), width 15
  .      ####     . 
  .    ########   . 
  .    ##    ##   . 
  .   ##      ##  . 
  .   ##      ##  . 
  .   ##      ##  . 
  .   ##      ##  . 
  .   ##     ###  . 
  .   ###   ####  . 
  .    ###### ##  . 
  .     ####  ##  . 
  .           ##  . 
  .          ##   . 
  .         ###   . 
  .   ########    . 
  .   ######      . 

Char 58 (colon), width 15
  .               . 
  .               . 
  .               . 
  .               . 
  .               . 
  .     ###       . 
  .     ###       . 
  .     ###       . 
  .               . 
  .               . 
  .               . 
  .               . 
  .               . 
  .     ###       . 
  .     ###       . 
  .     ###       . 
