Font: courR14 (Latin-1-bdf-sources/courR14.bdf)
Declared name: -Adobe-Courier-Medium-R-Normal--20-140-100-100-M-110-ISO10646-1
Declared family: courier
Declared weight: medium
Declared size: 20
Matching characters: 15
Height: 12
Baseline: 12
Max width: 11
Fixed width: True

Char: 32 (space), width: 11
  .           .
  .           .
  .           .
  .           .
  .           .
  .           .
  .           .
  .           .
  .           .
  .           .
  .           .
  _           _

Char: 43 (plus), width: 11
  .           .
  .           .
  .     #     .
  .     #     .
  .     #     .
  .     #     .
  . ######### .
  .     #     .
  .     #     .
  .     #     .
  .     #     .
  _           _

Char: 45 (hyphen), width: 11
  .           .
  .           .
  .           .
  .           .
  .           .
  .           .
  . ########  .
  .           .
  .           .
  .           .
  .           .
  _           _

Char: 46 (period), width: 11
  .           .
  .           .
  .           .
  .           .
  .           .
  .           .
  .           .
  .           .
  .           .
  .           .
  .    ##     .
  _    ##     _

Char: 48 (zero), width: 11
  .    ###    .
  .   #   #   .
  .  #     #  .
  .  #     #  .
  .  #     #  .
  .  #     #  .
  .  #     #  .
  .  #     #  .
  .  #     #  .
  .  #     #  .
  .   #   #   .
  _    ###    _

Char: 49 (one), width: 11
  .    ##     .
  .  ## #     .
  .     #     .
  .     #     .
  .     #     .
  .     #     .
  .     #     .
  .     #     .
  .     #     .
  .     #     .
  .     #     .
  _  #######  _

Char: 50 (two), width: 11
  .    ###    .
  .   #   #   .
  .  #     #  .
  .  #     #  .
  .        #  .
  .       #   .
  .      #    .
  .     #     .
  .    #      .
  .   #    #  .
  .  #     #  .
  _ ########  _

Char: 51 (three), width: 11
  .   ####    .
  .  #    #   .
  .        #  .
  .        #  .
  .       #   .
  .    ###    .
  .       #   .
  .        #  .
  .        #  .
  .        #  .
  .  #    #   .
  _   ####    _

Char: 52 (four), width: 11
  .      ##   .
  .     # #   .
  .     # #   .
  .    #  #   .
  .    #  #   .
  .   #   #   .
  .   #   #   .
  .  #    #   .
  .  #######  .
  .       #   .
  .       #   .
  _     ####  _

Char: 53 (five), width: 11
  .  ######   .
  .  #        .
  .  #        .
  .  #        .
  .  # ###    .
  .  ##   #   .
  .        #  .
  .        #  .
  .        #  .
  .        #  .
  . ##    #   .
  _   ####    _

Char: 54 (six), width: 11
  .     ###   .
  .   ##      .
  .   #       .
  .  #        .
  .  #        .
  .  # ###    .
  .  ##   #   .
  .  #     #  .
  .  #     #  .
  .  #     #  .
  .   #   #   .
  _    ###    _

Char: 55 (seven), width: 11
  .  #######  .
  .  #     #  .
  .        #  .
  .        #  .
  .       #   .
  .       #   .
  .       #   .
  .       #   .
  .      #    .
  .      #    .
  .      #    .
  _      #    _

Char: 56 (eight), width: 11
  .    ###    .
  .   #   #   .
  .  #     #  .
  .  #     #  .
  .   #   #   .
  .    ###    .
  .   #   #   .
  .  #     #  .
  .  #     #  .
  .  #     #  .
  .   #   #   .
  _    ###    _

Char: 57 (nine), width: 11
  .    ###    .
  .   #   #   .
  .  #     #  .
  .  #     #  .
  .  #     #  .
  .   #   ##  .
  .    ### #  .
  .        #  .
  .        #  .
  .       #   .
  .      ##   .
  _   ###     _

Char: 58 (colon), width: 11
  .           .
  .           .
  .           .
  .           .
  .    ##     .
  .    ##     .
  .           .
  .           .
  .           .
  .           .
  .    ##     .
  _    ##     _
