Font: open_iconic_embedded_2x (Symbols-bdf-sources/open_iconic_embedded_2x.bdf)
Declared name: open_iconic_embedded_2x
Declared family: iconic
Declared weight: none
Declared size: None
Characters: 17
Height: 16
Baseline: 16
Max width: 16
Fixed width: True

Char 64 (/home/kraus/git/open-iconic/png/battery-empty-2x.png), width 16
  .                . 
  .                . 
  .##############  . 
  .##############  . 
  .##          ##  . 
  .##          ##  . 
  .##          ####. 
  .##          ####. 
  .##          ####. 
  .##          ####. 
  .##          ##  . 
  .##          ##  . 
  .##############  . 
  .##############  . 
  .                . 
 __                __

Char 65 (/home/kraus/git/open-iconic/png/bell-2x.png), width 16
  .      ####      . 
  .     ######     . 
  .    ########    . 
  .    ########    . 
  .    ########    . 
  .    ########    . 
  .   ##########   . 
  .   ##########   . 
  .  ############  . 
  . ############## . 
  .################. 
  .################. 
  .                . 
  .                . 
  .      ####      . 
 __       ##       __

Char 66 (/home/kraus/git/open-iconic/png/cog-2x.png), width 16
  .       ##       . 
  .      ####      . 
  .  ### #### ###  . 
  .  ############  . 
  .  ############  . 
  .   ###    ###   . 
  . ####      #### . 
  .#####      #####. 
  .#####      #####. 
  . ####      #### . 
  .   ###    ###   . 
  .  ############  . 
  .  ############  . 
  .  ### #### ###  . 
  .      ####      . 
 __       ##       __

Char 67 (/home/kraus/git/open-iconic/png/flash-2x.png), width 16
  .       ###      . 
  .      ###       . 
  .      ###       . 
  .     ###        . 
  .     #######    . 
  .    #######     . 
  .        ###     . 
  .        ##      . 
  .       ###      . 
  .       ##       . 
  .    #######     . 
  .    ######      . 
  .     ####       . 
  .     ###        . 
  .     ##         . 
 __                __

Char 68 (/home/kraus/git/open-iconic/png/home-2x.png), width 16
  .       ##       . 
  .      ####      . 
  .     ######     . 
  .   ##########   . 
  .  ############  . 
  . ############## . 
  .  ############  . 
  .  ############  . 
  .  ############  . 
  .  ############  . 
  .  ####    ####  . 
  .  ####    ####  . 
  .  ####    ####  . 
  .  ####    ####  . 
  .                . 
 __                __

Char 69 (/home/kraus/git/open-iconic/png/pencil-2x.png), width 16
  .                . 
  .           ##   . 
  .           ###  . 
  .            ### . 
  .             ## . 
  .       ##       . 
  .      ####      . 
  .     ######     . 
  .    #######     . 
  .   #######      . 
  .  #######       . 
  . #######        . 
  .#######         . 
  .######          . 
  .#####           . 
 __####            __

Char 70 (/home/kraus/git/open-iconic/png/pulse-2x.png), width 16
  .                . 
  .      #         . 
  .      #         . 
  .     ###        . 
  .     ###        . 
  .     ###  ##    . 
  .     #### ##    . 
  .###### #########. 
  .###### #########. 
  .  #### ####     . 
  .   ##   ##      . 
  .   ##   ##      . 
  .   ##   ##      . 
  .                . 
  .                . 
 __                __

Char 71 (/home/kraus/git/open-iconic/png/warning-2x.png), width 16
  .      ##        . 
  .     ####       . 
  .     ####       . 
  .    #####       . 
  .    ######      . 
  .    ######      . 
  .   ###  ###     . 
  .   ###  ###     . 
  .  ####  ####    . 
  .  ####  ####    . 
  . ###########    . 
  . ############   . 
  . #####  #####   . 
  .######  ######  . 
  .##############  . 
 __##############  __

Char 72 (/home/kraus/git/open-iconic/png/wrench-2x.png), width 16
  .         ##     . 
  .       ####     . 
  .       ###      . 
  .      ####      . 
  .      ####      . 
  .      ####     #. 
  .      ##########. 
  .      ######### . 
  .     ########## . 
  .    #########   . 
  .   #####        . 
  .  #####         . 
  . #####          . 
  .#  ##           . 
  .#  #            . 
 __ ##             __

Char 73 (/home/kraus/git/open-iconic/png/battery-full-2x.png), width 16
  .                . 
  .                . 
  .##############  . 
  .##############  . 
  .##############  . 
  .##############  . 
  .################. 
  .################. 
  .################. 
  .################. 
  .##############  . 
  .##############  . 
  .##############  . 
  .##############  . 
  .                . 
 __                __

Char 74 (/home/kraus/git/open-iconic/png/bluetooth-2x.png), width 16
  .     ##         . 
  .     ###        . 
  .     ####       . 
  .     ## ###     . 
  .   # ##  ###    . 
  .   ####  ###    . 
  .    ### ###     . 
  .     ####       . 
  .     ####       . 
  .    ### ###     . 
  .   ####  ###    . 
  .   # ##  ###    . 
  .     ## ###     . 
  .     ####       . 
  .     ###        . 
 __     ##         __

Char 75 (/home/kraus/git/open-iconic/png/contrast-2x.png), width 16
  .     ######     . 
  .   ##########   . 
  .  ######  ####  . 
  . #######    ### . 
  . #######     ## . 
  .########     ###. 
  .########      ##. 
  .########      ##. 
  .########      ##. 
  .########      ##. 
  .########     ###. 
  . #######     ## . 
  . #######    ### . 
  .  ######  ####  . 
  .   ##########   . 
 __     ######     __

Char 76 (/home/kraus/git/open-iconic/png/hard-drive-2x.png), width 16
  .##############  . 
  .##############  . 
  .##############  . 
  .##############  . 
  .##############  . 
  .##############  . 
  .##############  . 
  .##############  . 
  .                . 
  .                . 
  .##############  . 
  .##############  . 
  .##########  ##  . 
  .##########  ##  . 
  .##############  . 
 __##############  __

Char 77 (/home/kraus/git/open-iconic/png/lightbulb-2x.png), width 16
  .        ##      . 
  .      ####      . 
  .    ####        . 
  .  ####    ##    . 
  .  ##    ####    . 
  .      ####      . 
  .    ####        . 
  .  ####    ##    . 
  .  ##    ####    . 
  .      ####      . 
  .    ######      . 
  .    ######      . 
  .                . 
  .                . 
  .     ####       . 
 __     ####       __

Char 78 (/home/kraus/git/open-iconic/png/power-standby-2x.png), width 16
  .      ##        . 
  .      ##        . 
  .      ##        . 
  .   #  ##  #     . 
  .  ##  ##  ##    . 
  . ##   ##   ##   . 
  .###   ##   ###  . 
  .##    ##    ##  . 
  .##          ##  . 
  .##          ##  . 
  .##          ##  . 
  .###        ###  . 
  . ##        ##   . 
  .  ###    ###    . 
  .   ########     . 
 __    ######      __

Char 79 (/home/kraus/git/open-iconic/png/reload-2x.png), width 16
  .     ######     . 
  .   ########## ##. 
  .  ####    ######. 
  . ###        ####. 
  . ##        #####. 
  .###       ######. 
  .##              . 
  .##              . 
  .##              . 
  .##              . 
  .###             . 
  . ##             . 
  . ###            . 
  .  ####    ###   . 
  .   ##########   . 
 __     ######     __

Char 80 (/home/kraus/git/open-iconic/png/wifi-2x.png), width 16
  .    #######     . 
  . #############  . 
  .####       #### . 
  . #              . 
  .                . 
  .                . 
  .     #####      . 
  .   #########    . 
  .    #     #     . 
  .                . 
  .                . 
  .                . 
  .      ###       . 
  .      ###       . 
  .      ###       . 
 __      ###       __
