Font: open_iconic_weather_2x (Symbols-bdf-sources/open_iconic_weather_2x.bdf)
Declared name: open_iconic_weather_2x
Declared family: iconic
Declared weight: none
Declared size: None
Characters: 6
Height: 16
Baseline: 16
Max width: 16
Fixed width: True

Char 64 (/home/kraus/git/open-iconic/png/cloud-2x.png), width 16
  .                . 
  .                . 
  .       ####     . 
  .     ########   . 
  .     ########   . 
  .    ##########  . 
  .  ############  . 
  . #############  . 
  .############### . 
  .################. 
  .################. 
  .################. 
  . ###############. 
  .  ############# . 
  .                . 
 __                __

Char 65 (/home/kraus/git/open-iconic/png/cloudy-2x.png), width 16
  .   ####         . 
  . ########       . 
  . #####          . 
  .#####           . 
  .####   ####     . 
  .###  ########   . 
  .##   ########   . 
  .    ##########  . 
  .  ############  . 
  . #############  . 
  .############### . 
  .################. 
  .################. 
  .################. 
  . ###############. 
 __  ############# __

Char 66 (/home/kraus/git/open-iconic/png/moon-2x.png), width 16
  .    #           . 
  .   ##           . 
  .  ###           . 
  . ####           . 
  . ####           . 
  .######          . 
  .######          . 
  .#######         . 
  .########        . 
  .#########       . 
  . ###########  # . 
  . ############## . 
  .  ############  . 
  .   ##########   . 
  .    ########    . 
 __       ##       __

Char 67 (/home/kraus/git/open-iconic/png/rain-2x.png), width 16
  .       ####     . 
  .     ########   . 
  .     ########   . 
  .    ##########  . 
  .  ############  . 
  . #############  . 
  .############### . 
  .################. 
  .#####    #######. 
  .####      ######. 
  .      ##     ###. 
  .      ##      # . 
  .  ##  ##  ##    . 
  .  ##  ##  ##    . 
  .  ##  ##  ##    . 
 __  ##  ##  ##    __

Char 68 (/home/kraus/git/open-iconic/png/star-2x.png), width 16
  .                . 
  .                . 
  .       ##       . 
  .       ##       . 
  .       ##       . 
  .      ####      . 
  . ############## . 
  .  ############  . 
  .   ##########   . 
  .    ########    . 
  .     ######     . 
  .     ######     . 
  .    ###  ###    . 
  .    ##    ##    . 
  .    #      #    . 
 __                __

Char 69 (/home/kraus/git/open-iconic/png/sun-2x.png), width 16
  .       ##       . 
  .       ##       . 
  .  ##        ##  . 
  .  ##        ##  . 
  .      ####      . 
  .     ######     . 
  .    ########    . 
  .##  ########  ##. 
  .##  ########  ##. 
  .    ########    . 
  .     ######     . 
  .      ####      . 
  .  ##        ##  . 
  .  ##        ##  . 
  .       ##       . 
 __       ##       __
