Font: open_iconic_other_2x (Symbols-bdf-sources/open_iconic_other_2x.bdf)
Declared name: open_iconic_other_2x
Declared family: iconic
Declared weight: none
Declared size: None
Characters: 8
Height: 16
Baseline: 16
Max width: 16
Fixed width: True

Char 64 (/home/kraus/git/open-iconic/png/bolt-2x.png), width 16
  .                . 
  .       #        . 
  .       #        . 
  .      ##        . 
  .     ###        . 
  .     ###        . 
  .    ########    . 
  .    #######     . 
  .   #######      . 
  .  ########      . 
  .      ###       . 
  .      ###       . 
  .      ##        . 
  .      #         . 
  .      #         . 
 __                __

Char 65 (/home/kraus/git/open-iconic/png/dial-2x.png), width 16
  .                . 
  .                . 
  .     ######     . 
  .   ##########   . 
  .  ####    ####  . 
  . ###        ### . 
  . ##   #  #   ## . 
  .###  ######  ###. 
  .##  ########  ##. 
  .##  ########  ##. 
  .    ########    . 
  .    ########    . 
  .     ######     . 
  .      ####      . 
  .                . 
 __                __

Char 66 (/home/kraus/git/open-iconic/png/fork-2x.png), width 16
  . ####    ####   . 
  .######  ######  . 
  .######  ######  . 
  .######  ######  . 
  .######  ######  . 
  . ####    ####   . 
  .  ##      ##    . 
  .  ##      ##    . 
  .  ##########    . 
  .  #########     . 
  . ####           . 
  .######          . 
  .######          . 
  .######          . 
  .######          . 
 __ ####           __

Char 67 (/home/kraus/git/open-iconic/png/grid-four-up-2x.png), width 16
  .##  ##  ##  ##  . 
  .##  ##  ##  ##  . 
  .                . 
  .                . 
  .##  ##  ##  ##  . 
  .##  ##  ##  ##  . 
  .                . 
  .                . 
  .##  ##  ##  ##  . 
  .##  ##  ##  ##  . 
  .                . 
  .                . 
  .##  ##  ##  ##  . 
  .##  ##  ##  ##  . 
  .                . 
 __                __

Char 68 (/home/kraus/git/open-iconic/png/grid-three-up-2x.png), width 16
  .####  ####  ####. 
  .####  ####  ####. 
  .####  ####  ####. 
  .####  ####  ####. 
  .                . 
  .                . 
  .####  ####  ####. 
  .####  ####  ####. 
  .####  ####  ####. 
  .####  ####  ####. 
  .                . 
  .                . 
  .####  ####  ####. 
  .####  ####  ####. 
  .####  ####  ####. 
 __####  ####  ####__

Char 69 (/home/kraus/git/open-iconic/png/grid-two-up-2x.png), width 16
  .######    ######. 
  .######    ######. 
  .######    ######. 
  .######    ######. 
  .######    ######. 
  .######    ######. 
  .                . 
  .                . 
  .                . 
  .                . 
  .######    ######. 
  .######    ######. 
  .######    ######. 
  .######    ######. 
  .######    ######. 
 __######    ######__

Char 70 (/home/kraus/git/open-iconic/png/signal-2x.png), width 16
  .            ##  . 
  .            ##  . 
  .        ##  ##  . 
  .        ##  ##  . 
  .        ##  ##  . 
  .        ##  ##  . 
  .    ##  ##  ##  . 
  .    ##  ##  ##  . 
  .    ##  ##  ##  . 
  .    ##  ##  ##  . 
  .##  ##  ##  ##  . 
  .##  ##  ##  ##  . 
  .##  ##  ##  ##  . 
  .##  ##  ##  ##  . 
  .##  ##  ##  ##  . 
 __##  ##  ##  ##  __

Char 71 (/home/kraus/git/open-iconic/png/target-2x.png), width 16
  .     ######     . 
  .   ##########   . 
  .  ####    ####  . 
  . ###        ### . 
  . ##   ####   ## . 
  .###  ######  ###. 
  .##  ###  ###  ##. 
  .##  ##    ##  ##. 
  .##  ##    ##  ##. 
  .##  ###  ###  ##. 
  .###  ######  ###. 
  . ##   ####   ## . 
  . ###        ### . 
  .  ####    ####  . 
  .   ##########   . 
 __     ######     __
