Font: _open_iconic_human_6x (Symbols-bdf-sources/open_iconic_human_6x.bdf)
Declared name: "open_iconic_human_6x"
Declared family: None
Declared weight: None
Declared size: None
Matching characters: 5
Height: 48
Baseline: 48
Max width: 48
Fixed width: True

Char: 64 (/home/kraus/git/open-iconic/png/eye-6x.png), width: 48
  .                                                .
  .                                                .
  .                                                .
  .                                                .
  .                                                .
  .                                                .
  .                    ########                    .
  .                 ##############                 .
  .               ###################              .
  .             ######################             .
  .           ##########################           .
  .          ############################          .
  .         ############      ############         .
  .        ##########            ##########        .
  .       ##########              ##########       .
  .      ##########                ##########      .
  .     ##########                  ##########     .
  .    ##########                    ##########    .
  .    #########         ###          #########    .
  .   ##########       ####           ##########   .
  .  ###########      #####           ###########  .
  . ###########       #####            ########### .
  . ###########      ######            ########### .
  .############      #######    #      ############.
  .############      ############      ############.
  . ###########      ############      ########### .
  . ###########       ##########       ########### .
  .  ###########      ##########      ###########  .
  .   ##########       ########       ##########   .
  .    #########         ####         #########    .
  .    ##########                    ##########    .
  .     ##########                  ##########     .
  .      ##########                ##########      .
  .       ##########              ##########       .
  .        ##########            ##########        .
  .         ############      ############         .
  .          ############################          .
  .           ##########################           .
  .             ######################             .
  .               ###################              .
  .                 ##############                 .
  .                    ########                    .
  .                                                .
  .                                                .
  .                                                .
  .                                                .
  .                                                .
  _                                                _

Char: 65 (/home/kraus/git/open-iconic/png/eyedropper-6x.png), width: 48
  .                   ####             ######      .
  .                  ######          ##########    .
  .                  #######        ############   .
  .                  ########      ##############  .
  .                  #########    ################ .
  .                   #########  ################# .
  .                    ############################.
  .                     ###########################.
  .                      ##########################.
  .                      ##########################.
  .                     ###########################.
  .                    ############################.
  .                   ############################ .
  .                  ######## #################### .
  .                 ########   ##################  .
  .                ########     ################   .
  .               ########       ##############    .
  .              ########         ############     .
  .             ########           ##########      .
  .            ########             #########      .
  .           ########               #########     .
  .          #########               ##########    .
  .         #########               ############   .
  .        #########               ##############  .
  .       #########               ################ .
  .      #########               ##################.
  .     #########               #########  ########.
  .    #########               #########    #######.
  .   #########               #########      ######.
  .  #########               #########        #### .
  . #########               #########              .
  .#########               #########               .
  .########               #########                .
  .#########             #########                 .
  .##########           #########                  .
  .###########         #########                   .
  .############       #########                    .
  .#############     #########                     .
  .##############   #########                      .
  .############### #########                       .
  .########################                        .
  .#######################                         .
  .######################                          .
  .#####################                           .
  .####################                            .
  .###################                             .
  .##################                              .
  _#################                               _

Char: 66 (/home/kraus/git/open-iconic/png/heart-6x.png), width: 48
  .                                                .
  .                                                .
  .                                                .
  .                                                .
  .                                                .
  .                                                .
  .         ######                  ######         .
  .      ############            ############      .
  .     ##############          ##############     .
  .    ################        ################    .
  .   ##################      ##################   .
  .  ####################    ####################  .
  . ######################  ###################### .
  . ######################  ###################### .
  . ######################  ###################### .
  .################################################.
  .################################################.
  .################################################.
  .################################################.
  .################################################.
  .################################################.
  . ############################################## .
  . ############################################## .
  . ############################################## .
  .  ############################################  .
  .   ##########################################   .
  .    ########################################    .
  .     ######################################     .
  .      ####################################      .
  .       ##################################       .
  .        ################################        .
  .         ##############################         .
  .          ############################          .
  .           ##########################           .
  .            ########################            .
  .             ######################             .
  .              ####################              .
  .               ##################               .
  .                ################                .
  .                 ##############                 .
  .                  ############                  .
  .                   ##########                   .
  .                    ########                    .
  .                     ######                     .
  .                      ####                      .
  .                       ##                       .
  .                                                .
  _                                                _

Char: 67 (/home/kraus/git/open-iconic/png/people-6x.png), width: 48
  .                              #####             .
  .                             ########           .
  .                            ##########          .
  .                           ############         .
  .                          ##############        .
  .                          ##############        .
  .            ######         ##############       .
  .           ########        ##############       .
  .          ##########        ##############      .
  .         ############       ##############      .
  .        ##############       #############      .
  .       ################      #############      .
  .       ################      #############      .
  .       ################       ############      .
  .      ##################      ############      .
  .      ##################      ############      .
  .      ##################      ###########       .
  .      ##################      ###########       .
  .      ##################      ###########       .
  .      ##################      ##########        .
  .      ##################      #########         .
  .      ##################      ########          .
  .       ################       #######           .
  .       ################        #####            .
  .       ################                         .
  .        ##############                     #    .
  .         ############                     ####  .
  .          ##########                     ###### .
  .           ########                    ######## .
  .            #####                    ###########.
  .                                  ##############.
  .    #                    #        ##############.
  .  ####                  ####       #############.
  .  #####                #####       #############.
  . ########            ########       ############.
  .###########        ###########      ############.
  .##############################      ############.
  .##############################      ############.
  .##############################      ############.
  .##############################      ############.
  .##############################      ############.
  .##############################      ############.
  .##############################                  .
  .##############################                  .
  .##############################                  .
  .##############################                  .
  .##############################                  .
  _##############################                  _

Char: 68 (/home/kraus/git/open-iconic/png/person-6x.png), width: 48
  .                     ######                     .
  .                   ##########                   .
  .                 ##############                 .
  .                ################                .
  .               ##################               .
  .               ##################               .
  .              ####################              .
  .              ####################              .
  .             ######################             .
  .             ######################             .
  .             ######################             .
  .            ########################            .
  .            ########################            .
  .            ########################            .
  .            ########################            .
  .            ########################            .
  .            ########################            .
  .            ########################            .
  .            ########################            .
  .             ######################             .
  .             ######################             .
  .             ######################             .
  .              ####################              .
  .              ####################              .
  .               ##################               .
  .               ##################               .
  .                ################                .
  .                 ##############                 .
  .                   ##########                   .
  .                     ######                     .
  .         ###                        ###         .
  .      #######                      #######      .
  .     #########                    #########     .
  .    ############                ############    .
  .   ##############              ##############   .
  .  ##################        ##################  .
  . ############################################## .
  . ############################################## .
  . ############################################## .
  .################################################.
  .################################################.
  .################################################.
  .################################################.
  .################################################.
  .################################################.
  .################################################.
  .################################################.
  _################################################_
