Font: open_iconic_www_2x (Symbols-bdf-sources/open_iconic_www_2x.bdf)
Declared name: "open_iconic_www_2x"
Declared family: None
Declared weight: None
Declared size: None
Matching characters: 20
Height: 16
Baseline: 16
Max width: 16
Fixed width: True

Char: 64 (/home/kraus/git/open-iconic/png/badge-2x.png), width: 16
  .      ####      .
  .     ######     .
  .    ########    .
  .    ########    .
  .    ########    .
  .    ########    .
  .     ######     .
  .      ####      .
  .                .
  .                .
  .      ####      .
  .      ####      .
  .      ####      .
  .      ####      .
  .      #  #      .
  _                _

Char: 65 (/home/kraus/git/open-iconic/png/bookmark-2x.png), width: 16
  .    ########    .
  .    ########    .
  .    ########    .
  .    ########    .
  .    ########    .
  .    ########    .
  .    ########    .
  .    ########    .
  .    ########    .
  .    ########    .
  .    ########    .
  .    ########    .
  .    ###  ###    .
  .    ##    ##    .
  .    #      #    .
  _                _

Char: 66 (/home/kraus/git/open-iconic/png/cart-2x.png), width: 16
  .                .
  .                .
  .######          .
  .######          .
  .    ############.
  .     ########## .
  .     ########## .
  .     ########## .
  .     #########  .
  .      ########  .
  .                .
  .                .
  .      ##    ##  .
  .      ##    ##  .
  .                .
  _                _

Char: 67 (/home/kraus/git/open-iconic/png/cloud-upload-2x.png), width: 16
  .       ####     .
  .     ########   .
  .     ########   .
  .    ##########  .
  .  ############  .
  . #############  .
  .########  ##### .
  .#######    #####.
  .######      ####.
  .#####        ###.
  .        ##      .
  .       ####     .
  .      ######    .
  .     ########   .
  .        ##      .
  _        ##      _

Char: 68 (/home/kraus/git/open-iconic/png/flag-2x.png), width: 16
  .##  ######      .
  .##  ######      .
  .##  ########### .
  .##  ########### .
  .##  ##########  .
  .##  #########   .
  .##  ########    .
  .##  #########   .
  .##      ######  .
  .##      ####### .
  .##              .
  .##              .
  .##              .
  .##              .
  .##              .
  _##              _

Char: 69 (/home/kraus/git/open-iconic/png/link-broken-2x.png), width: 16
  .    ##    ####  .
  .    ##   ###### .
  .  ####  ###  ###.
  .  ####  ##    ##.
  .              ##.
  .             ###.
  .    ##      ### .
  .   ###     ###  .
  .  ###     ###   .
  . ###      ##    .
  .###             .
  .##              .
  .##    ##  ####  .
  .###  ###  ####  .
  . ######   ##    .
  _  ####    ##    _

Char: 70 (/home/kraus/git/open-iconic/png/location-2x.png), width: 16
  .                .
  .             ## .
  .           #### .
  .         #####  .
  .       #######  .
  .     ########   .
  .   ##########   .
  . ###########    .
  .  ##########    .
  .     ######     .
  .      #####     .
  .       ###      .
  .       ###      .
  .       ##       .
  .        #       .
  _                _

Char: 71 (/home/kraus/git/open-iconic/png/map-marker-2x.png), width: 16
  .      ####      .
  .    ########    .
  .   ###    ###   .
  .   ##      ##   .
  .  ##        ##  .
  .  ##        ##  .
  .  ##        ##  .
  .  ##        ##  .
  .   ##      ##   .
  .   ###    ###   .
  .    ########    .
  .    ########    .
  .     ######     .
  .      ####      .
  .       ##       .
  _                _

Char: 72 (/home/kraus/git/open-iconic/png/rss-alt-2x.png), width: 16
  .####            .
  .#######         .
  .#########       .
  .##########      .
  .   ########     .
  .      ######    .
  .###    ######   .
  .#####   ######  .
  .#######  #####  .
  .########  ##### .
  .  ######   #### .
  .    #####  #### .
  .##   ####  #####.
  .###  #####  ####.
  .####  ####  ####.
  _####  ####  ####_

Char: 73 (/home/kraus/git/open-iconic/png/thumb-up-2x.png), width: 16
  .        ##      .
  .        ##      .
  .       ###      .
  .       ##       .
  .      ###       .
  .     ####       .
  .##  ##########  .
  .##  ##########  .
  .##  ##########  .
  .##  #########   .
  .##  #########   .
  .##  #########   .
  .##  ########    .
  .##  ########    .
  .                .
  _                _

Char: 74 (/home/kraus/git/open-iconic/png/ban-2x.png), width: 16
  .     ######     .
  .   ##########   .
  .  ####    ####  .
  . ###       #### .
  . ##       ##### .
  .###      ### ###.
  .##      ###   ##.
  .##     ###    ##.
  .##    ###     ##.
  .##   ###      ##.
  .### ###      ###.
  . #####       ## .
  . ####       ### .
  .  ####    ####  .
  .   ##########   .
  _     ######     _

Char: 75 (/home/kraus/git/open-iconic/png/browser-2x.png), width: 16
  .################.
  .################.
  .##  ##        ##.
  .##  ##        ##.
  .################.
  .################.
  .##            ##.
  .##            ##.
  .##            ##.
  .##            ##.
  .##            ##.
  .##            ##.
  .##            ##.
  .##            ##.
  .################.
  _################_

Char: 76 (/home/kraus/git/open-iconic/png/cloud-download-2x.png), width: 16
  .       ####     .
  .     ########   .
  .     ########   .
  .    ##########  .
  .  ############  .
  . #############  .
  .#######    #### .
  .######      ####.
  .######  ##  ####.
  .######  ##  ####.
  .        ##      .
  .        ##      .
  .      ######    .
  .       ####     .
  .        ##      .
  _                _

Char: 77 (/home/kraus/git/open-iconic/png/external-link-2x.png), width: 16
  .####     #######.
  .####      ######.
  .##         #####.
  .##         #####.
  .##        ######.
  .##       ###  ##.
  .##      ###    #.
  .##     ###      .
  .##     ##       .
  .##              .
  .##              .
  .##              .
  .##            ##.
  .##            ##.
  .################.
  _################_

Char: 78 (/home/kraus/git/open-iconic/png/globe-2x.png), width: 16
  .     ######     .
  .   ##########   .
  .  ####   #####  .
  . #####   ###### .
  . ####     ## ## .
  .####      ## ###.
  .###       ######.
  .###       ######.
  .##       #######.
  .##       #######.
  .####       #####.
  . ####        ## .
  . #####      ### .
  .  ####    ####  .
  .   ##########   .
  _     ######     _

Char: 79 (/home/kraus/git/open-iconic/png/link-intact-2x.png), width: 16
  .          ####  .
  .         ###### .
  .         ##  ###.
  .              ##.
  .              ##.
  .     #####   ###.
  .    ######  ### .
  .   ###     ###  .
  .  ###     ###   .
  . ###  ######    .
  .###   #####     .
  .##              .
  .##              .
  .###  ##         .
  . ######         .
  _  ####          _

Char: 80 (/home/kraus/git/open-iconic/png/map-2x.png), width: 16
  .################.
  .################.
  .##            ##.
  .##            ##.
  .##   ####     ##.
  .##  ######    ##.
  .##  ##  ##    ##.
  .##  ##  ##    ##.
  .##  ######    ##.
  .##   ####     ##.
  .##    ##  ######.
  .##        ######.
  .##            ##.
  .##            ##.
  .################.
  _################_

Char: 81 (/home/kraus/git/open-iconic/png/rss-2x.png), width: 16
  .  ####          .
  .  ######        .
  .     #####      .
  .        ###     .
  .  ###    ###    .
  .  #####   ###   .
  .     ####  ###  .
  .       ###  ##  .
  .  ##    ##   ## .
  .  ####   ##  ## .
  .    ###  ##  ###.
  .     ##   ##  ##.
  . ##   ##  ##  ##.
  .####  ##  ##  ##.
  .####            .
  _ ##             _

Char: 82 (/home/kraus/git/open-iconic/png/thumb-down-2x.png), width: 16
  .##  ########    .
  .##  ########    .
  .##  #########   .
  .##  #########   .
  .##  #########   .
  .##  ##########  .
  .##  ##########  .
  .##  ##########  .
  .     ####       .
  .      ###       .
  .       ##       .
  .       ###      .
  .        ##      .
  .        ##      .
  .                .
  _                _

Char: 83 (/home/kraus/git/open-iconic/png/transfer-2x.png), width: 16
  .            #   .
  .            ##  .
  .############### .
  .############### .
  .            ##  .
  .            #   .
  .                .
  .                .
  .   #            .
  .  ##            .
  . ###############.
  . ###############.
  .  ##            .
  .   #            .
  .                .
  _                _
