Font: open_iconic_app_2x (Symbols-bdf-sources/open_iconic_app_2x.bdf)
Declared name: "open_iconic_app_2x"
Declared family: None
Declared weight: None
Declared size: None
Matching characters: 9
Height: 16
Baseline: 16
Max width: 16
Fixed width: True

Char: 64 (/home/kraus/git/open-iconic/png/aperture-2x.png), width: 16
  .     ######     .
  .     #######    .
  .  #   ######    .
  . ###    ###  ## .
  . #####   ##  ## .
  .######       ###.
  .####        ####.
  .###         ####.
  .#           ####.
  .           #####.
  .  ###           .
  . ####           .
  . ####   ####### .
  .  ####  ######  .
  .   ###  #####   .
  _     #   ##     _

Char: 65 (/home/kraus/git/open-iconic/png/calculator-2x.png), width: 16
  .##############  .
  .##############  .
  .##          ##  .
  .##          ##  .
  .##          ##  .
  .##          ##  .
  .##############  .
  .##############  .
  .##  ##  ##  ##  .
  .##  ##  ##  ##  .
  .##########  ##  .
  .##########  ##  .
  .##  ##  ##  ##  .
  .##  ##  ##  ##  .
  .##############  .
  _##############  _

Char: 66 (/home/kraus/git/open-iconic/png/calendar-2x.png), width: 16
  .##############  .
  .##############  .
  .##############  .
  .##############  .
  .                .
  .                .
  .##############  .
  .##############  .
  .##  ##  ##  ##  .
  .##  ##  ##  ##  .
  .##############  .
  .##############  .
  .##  ##  ######  .
  .##  ##  ######  .
  .##############  .
  _##############  _

Char: 67 (/home/kraus/git/open-iconic/png/camera-slr-2x.png), width: 16
  .        ####    .
  .       ######   .
  .       ######   .
  .      ########  .
  . ###############.
  .################.
  .##  ####    ####.
  .##  ###      ###.
  .######   ##   ##.
  .######  ####  ##.
  .######  ####  ##.
  .######   ##   ##.
  .#######      ###.
  .########    ####.
  .################.
  _################_

Char: 68 (/home/kraus/git/open-iconic/png/chat-2x.png), width: 16
  .##########      .
  .##########      .
  .####            .
  .####            .
  .####  ##########.
  .####  ##########.
  .####  ##########.
  .####  ##########.
  .#     ##########.
  .      ##########.
  .      ##########.
  .      ##########.
  .               #.
  .                .
  .                .
  _                _

Char: 69 (/home/kraus/git/open-iconic/png/clock-2x.png), width: 16
  .     ######     .
  .   ##########   .
  .  ####    ####  .
  . ###        ### .
  . ##    ##    ## .
  .###    ##    ###.
  .##     ##     ##.
  .##     ##     ##.
  .##     ###    ##.
  .##      ##    ##.
  .###          ###.
  . ##          ## .
  . ###        ### .
  .  ####    ####  .
  .   ##########   .
  _     ######     _

Char: 70 (/home/kraus/git/open-iconic/png/compass-2x.png), width: 16
  .     ######     .
  .   ##########   .
  .  ####    ####  .
  . ###        ### .
  . ##        # ## .
  .###     ###  ###.
  .##    #####   ##.
  .##    #  ##   ##.
  .##   ##  #    ##.
  .##   #####    ##.
  .###  ###     ###.
  . ## #        ## .
  . ###        ### .
  .  ####    ####  .
  .   ##########   .
  _     ######     _

Char: 71 (/home/kraus/git/open-iconic/png/shield-2x.png), width: 16
  .       ##       .
  .    ########    .
  .  ##### ######  .
  .#####   ########.
  .##      ########.
  .##      ########.
  .##      ########.
  . ##     ####### .
  . ##     ####### .
  . ##     ####### .
  .  ##    ######  .
  .  ###   ######  .
  .   ###  #####   .
  .    ### ####    .
  .     ######     .
  _      ####      _

Char: 72 (/home/kraus/git/open-iconic/png/timer-2x.png), width: 16
  .    ######      .
  .    ######      .
  .    #####       .
  .   ######       .
  .  ###      #    .
  . ##       #     .
  .###      #      .
  .##     ###  ##  .
  .##    ###   ##  .
  .##    ##    ##  .
  .##          ##  .
  .###        ###  .
  . ##        ##   .
  .  ###    ###    .
  .   ########     .
  _    ######      _
