Font: _cursorr (Symbols-bdf-sources/cursorr.bdf)
Declared name: cursor
Declared family: None
Declared weight: None
Declared size: None
Matching characters: 6
Height: 21
Baseline: 6
Max width: 17
Fixed width: True

Char: 68 (left_ptr), width: 17
  .                 .
  .                 .
  .                 .
  .                 .
  .                 .
  _                 _
  .#                .
  .##               .
  .###              .
  .####             .
  .#####            .
  .######           .
  .#######          .
  .########         .
  .#####            .
  .## ##            .
  .#   ##           .
  .    ##           .
  .     ##          .
  .     ##          .
  .                 .

Char: 69 (left_ptr_mask), width: 17
  .                 .
  .                 .
  .                 .
  .                 .
  .                 .
  _##               _
  .###              .
  .####             .
  .#####            .
  .######           .
  .#######          .
  .########         .
  .#########        .
  .##########       .
  .##########       .
  .#######          .
  .### ####         .
  .##  ####         .
  .     ####        .
  .     ####        .
  .      ##         .

Char: 90 (plus), width: 17
  .                 .
  .    ##           .
  .    ##           .
  .    ##           .
  .    ##           .
  _##########       _
  .##########       .
  .    ##           .
  .    ##           .
  .    ##           .
  .    ##           .
  .                 .
  .                 .
  .                 .
  .                 .
  .                 .
  .                 .
  .                 .
  .                 .
  .                 .
  .                 .

Char: 91 (plus_mask), width: 17
  .    ####         .
  .    ####         .
  .    ####         .
  .    ####         .
  .############     .
  _############     _
  .############     .
  .############     .
  .    ####         .
  .    ####         .
  .    ####         .
  .    ####         .
  .                 .
  .                 .
  .                 .
  .                 .
  .                 .
  .                 .
  .                 .
  .                 .
  .                 .

Char: 94 (right_ptr), width: 17
  .                 .
  .                 .
  .                 .
  .                 .
  .                 .
  _                 _
  .       #         .
  .      ##         .
  .     ###         .
  .    ####         .
  .   #####         .
  .  ######         .
  . #######         .
  .########         .
  .   #####         .
  .   ## ##         .
  .  ##   #         .
  .  ##             .
  . ##              .
  . ##              .
  .                 .

Char: 95 (right_ptr_mask), width: 17
  .                 .
  .                 .
  .                 .
  .                 .
  .                 .
  _        ##       _
  .       ###       .
  .      ####       .
  .     #####       .
  .    ######       .
  .   #######       .
  .  ########       .
  . #########       .
  .##########       .
  .##########       .
  .   #######       .
  .  #### ###       .
  .  ####  ##       .
  . ####            .
  . ####            .
  .  ##             .
