Font: open_iconic_email_8x (Symbols-bdf-sources/open_iconic_email_8x.bdf)
Declared name: "open_iconic_email_8x"
Declared family: None
Declared weight: None
Declared size: None
Matching characters: 5
Height: 64
Baseline: 64
Max width: 64
Fixed width: True

Char: 64 (/home/kraus/git/open-iconic/png/envelope-closed-8x.png), width: 64
  .                                                                .
  .                                                                .
  .                                                                .
  .                                                                .
  .                                                                .
  .                                                                .
  .                                                                .
  .                                                                .
  .################################################################.
  .################################################################.
  .################################################################.
  .################################################################.
  .################################################################.
  .################################################################.
  .################################################################.
  .################################################################.
  . ############################################################## .
  .   ##########################################################   .
  .     ######################################################     .
  .       ##################################################       .
  .         ##############################################         .
  .           ##########################################           .
  .             ######################################             .
  .               ##################################               .
  .#                ##############################                #.
  .###                ##########################                ###.
  .#####                ######################                #####.
  .#######                ##################                #######.
  .#########                ##############                #########.
  .###########                ##########                ###########.
  .#############                ######                #############.
  .###############                ##                ###############.
  .#################                              #################.
  .###################                          ###################.
  .#####################                      #####################.
  .#######################                  #######################.
  .#########################              #########################.
  .###########################          ###########################.
  .#############################      #############################.
  .###############################  ###############################.
  .################################################################.
  .################################################################.
  .################################################################.
  .################################################################.
  .################################################################.
  .################################################################.
  .################################################################.
  .################################################################.
  .################################################################.
  .################################################################.
  .################################################################.
  .################################################################.
  .################################################################.
  .################################################################.
  .################################################################.
  .################################################################.
  .                                                                .
  .                                                                .
  .                                                                .
  .                                                                .
  .                                                                .
  .                                                                .
  .                                                                .
  _                                                                _

Char: 65 (/home/kraus/git/open-iconic/png/envelope-open-8x.png), width: 64
  .                               ##                               .
  .                             ######                             .
  .                           ##########                           .
  .                         ##############                         .
  .                       ##################                       .
  .                     ######################                     .
  .                   ##########################                   .
  .                 ##############################                 .
  .               ##################################               .
  .             ##################  ##################             .
  .           ##################      ##################           .
  .         ##################          ##################         .
  .       ##################              ##################       .
  .     ##################                  ##################     .
  .   ##################                      ##################   .
  . ##################                          ################## .
  .#################                              #################.
  .###############                                  ###############.
  .#############                                      #############.
  .###########                                          ###########.
  .#########                                              #########.
  .########                                                ########.
  .########                                                ########.
  .########                                                ########.
  .########        ################################        ########.
  .########        ################################        ########.
  .########        ################################        ########.
  .########        ################################        ########.
  .########        ################################        ########.
  .########        ################################        ########.
  .########        ################################        ########.
  .########        ################################        ########.
  .########         ##############################         ########.
  .########           ##########################           ########.
  .########             ######################             ########.
  .########               ##################               ########.
  .#########                ##############                #########.
  .###########                ##########                ###########.
  .#############                ######                #############.
  .###############                ##                ###############.
  .#################                              #################.
  .###################                          ###################.
  .#####################                      #####################.
  .#######################                  #######################.
  .#########################              #########################.
  .###########################          ###########################.
  .#############################      #############################.
  .###############################  ###############################.
  .################################################################.
  .################################################################.
  .################################################################.
  .################################################################.
  .################################################################.
  .################################################################.
  .################################################################.
  .################################################################.
  .################################################################.
  .################################################################.
  .################################################################.
  .################################################################.
  .################################################################.
  .################################################################.
  .################################################################.
  _################################################################_

Char: 66 (/home/kraus/git/open-iconic/png/inbox-8x.png), width: 64
  .################################################################.
  .################################################################.
  .################################################################.
  .################################################################.
  .################################################################.
  .################################################################.
  .################################################################.
  .################################################################.
  .################################################################.
  .################################################################.
  .################################################################.
  .################################################################.
  .################################################################.
  .################################################################.
  .################################################################.
  .################################################################.
  .########                                                ########.
  .########                                                ########.
  .########                                                ########.
  .########                                                ########.
  .########                                                ########.
  .########                                                ########.
  .########                                                ########.
  .########                                                ########.
  .########                                                ########.
  .########                                                ########.
  .########                                                ########.
  .########                                                ########.
  .########                                                ########.
  .########                                                ########.
  .########                                                ########.
  .########                                                ########.
  .########                                                ########.
  .########                                                ########.
  .########                                                ########.
  .########                                                ########.
  .########                                                ########.
  .########                                                ########.
  .########                                                ########.
  .########                                                ########.
  .################                                ################.
  .#################                              #################.
  .##################                            ##################.
  .###################                          ###################.
  .####################                        ####################.
  .#####################                      #####################.
  .######################                    ######################.
  .#######################                  #######################.
  .################################################################.
  .################################################################.
  .################################################################.
  .################################################################.
  .################################################################.
  .################################################################.
  .################################################################.
  .################################################################.
  .################################################################.
  .################################################################.
  .################################################################.
  .################################################################.
  .################################################################.
  .################################################################.
  .################################################################.
  _################################################################_

Char: 67 (/home/kraus/git/open-iconic/png/tag-8x.png), width: 64
  .########################                                        .
  .#########################                                       .
  .##########################                                      .
  .###########################                                     .
  .############################                                    .
  .#############################                                   .
  .##############################                                  .
  .###############################                                 .
  .#############      #############                                .
  .###########          ############                               .
  .##########            ############                              .
  .#########              ############                             .
  .#########              #############                            .
  .########                #############                           .
  .########                ##############                          .
  .########                ###############                         .
  .########                ################                        .
  .########                #################                       .
  .########                ##################                      .
  .#########              ####################                     .
  .#########              #####################                    .
  .##########            #######################                   .
  .###########          #########################                  .
  .#############      ############################                 .
  . ###############################################                .
  .  ###############################################               .
  .   ###############################################              .
  .    ###############################################             .
  .     ###############################################            .
  .      ###############################################           .
  .       ###############################################          .
  .        ###############################################         .
  .         ###############################################        .
  .          ###############################################       .
  .           ###############################################      .
  .            ###############################################     .
  .             ###############################################    .
  .              ###############################################   .
  .               ###############################################  .
  .                ############################################### .
  .                 ############################################## .
  .                  ############################################  .
  .                   ##########################################   .
  .                    ########################################    .
  .                     ######################################     .
  .                      ####################################      .
  .                       ##################################       .
  .                        ################################        .
  .                         ##############################         .
  .                          ############################          .
  .                           ##########################           .
  .                            ########################            .
  .                             ######################             .
  .                              ####################              .
  .                               ##################               .
  .                                ################                .
  .                                 ##############                 .
  .                                  ############                  .
  .                                   ##########                   .
  .                                    ########                    .
  .                                     ######                     .
  .                                      ####                      .
  .                                       ##                       .
  _                                                                _

Char: 68 (/home/kraus/git/open-iconic/png/tags-8x.png), width: 64
  .                                                                .
  .                                                                .
  .                                                                .
  .                                                                .
  .                                                                .
  .                                                                .
  .                                                                .
  .                                                                .
  .################            ############                        .
  .#################            ############                       .
  .##################            ############                      .
  .###################            ############                     .
  .####################            ############                    .
  .#####################            ############                   .
  .######################            ############                  .
  .#######################            ############                 .
  .##########    ##########            ############                .
  .#########      ##########            ############               .
  .########        ##########            ############              .
  .########        ###########            ############             .
  .########        ############            ############            .
  .########        #############            ############           .
  .#########      ###############            ############          .
  .##########    #################            ############         .
  . ###############################            ############        .
  .  ###############################            ############       .
  .   ###############################            ############      .
  .    ###############################            ############     .
  .     ###############################            ############    .
  .      ###############################            ############   .
  .       ###############################            ############  .
  .        ###############################            ############ .
  .         ##############################            ############ .
  .          ############################            ############  .
  .           ##########################            ############   .
  .            ########################            ############    .
  .             ######################            ############     .
  .              ####################            ############      .
  .               ##################            ############       .
  .                ################            ############        .
  .                 ##############            ############         .
  .                  ############            ############          .
  .                   ##########              ##########           .
  .                    ########                ########            .
  .                     ######                  ######             .
  .                      ####                    ####              .
  .                       ##                      ##               .
  .                                                                .
  .                                                                .
  .                                                                .
  .                                                                .
  .                                                                .
  .                                                                .
  .                                                                .
  .                                                                .
  .                                                                .
  .                                                                .
  .                                                                .
  .                                                                .
  .                                                                .
  .                                                                .
  .                                                                .
  .                                                                .
  _                                                                _
