Font: _open_iconic_check_2x (Symbols-bdf-sources/open_iconic_check_2x.bdf)
Declared name: "open_iconic_check_2x"
Declared family: None
Declared weight: None
Declared size: None
Matching characters: 5
Height: 16
Baseline: 16
Max width: 16
Fixed width: True

Char: 64 (/home/kraus/git/open-iconic/png/check-2x.png), width: 16
  .                .
  .                .
  .            #   .
  .           ###  .
  .          ##### .
  .         ###### .
  .  #     ######  .
  . ###   ######   .
  .##### ######    .
  . ##########     .
  .  ########      .
  .   ######       .
  .    ####        .
  .     ##         .
  .                .
  _                _

Char: 65 (/home/kraus/git/open-iconic/png/circle-check-2x.png), width: 16
  .     ######     .
  .   ##########   .
  .  ############  .
  . ############## .
  . ##########  ## .
  .##########   ###.
  .#########   ####.
  .####  ##   #####.
  .####      ######.
  .#####    #######.
  .######  ########.
  . ############## .
  . ############## .
  .  ############  .
  .   ##########   .
  _     ######     _

Char: 66 (/home/kraus/git/open-iconic/png/circle-x-2x.png), width: 16
  .     ######     .
  .   ##########   .
  .  ############  .
  . ############## .
  . ###  ####  ### .
  .####   ##   ####.
  .#####      #####.
  .######    ######.
  .######    ######.
  .#####      #####.
  .####   ##   ####.
  . ###  ####  ### .
  . ############## .
  .  ############  .
  .   ##########   .
  _     ######     _

Char: 67 (/home/kraus/git/open-iconic/png/task-2x.png), width: 16
  .###########     .
  .##########   ## .
  .##          ### .
  .##         ###  .
  .##        ###   .
  .##   ##  ###    .
  .##   ######     .
  .##    ####   #  .
  .##     ##   ##  .
  .##          ##  .
  .##          ##  .
  .##          ##  .
  .##############  .
  .##############  .
  .                .
  _                _

Char: 68 (/home/kraus/git/open-iconic/png/x-2x.png), width: 16
  .  #         #   .
  . ###       ###  .
  .#####     ##### .
  . #####   ###### .
  .  ##### ######  .
  .   ##########   .
  .    ########    .
  .     ######     .
  .    #######     .
  .   #########    .
  .  ###########   .
  . ######  #####  .
  .######    ##### .
  . ####      #### .
  .  ##        ##  .
  _                _
