Font: _open_iconic_thing_2x (Symbols-bdf-sources/open_iconic_thing_2x.bdf)
Declared name: "open_iconic_thing_2x"
Declared family: None
Declared weight: None
Declared size: None
Matching characters: 19
Height: 16
Baseline: 16
Max width: 16
Fixed width: True

Char: 64 (/home/kraus/git/open-iconic/png/basket-2x.png), width: 16
  .       ##       .
  .      ####      .
  .     ######     .
  .     ##  ##     .
  .    ##    ##    .
  .   ###    ###   .
  .################.
  .################.
  .  ############  .
  .  ############  .
  .  ##  ####  ##  .
  .  ##  ####  ##  .
  .  ##  ####  ##  .
  .  ##  ####  ##  .
  .  ############  .
  _  ############  _

Char: 65 (/home/kraus/git/open-iconic/png/briefcase-2x.png), width: 16
  .     ######     .
  .    ########    .
  .    ##    ##    .
  .    ##    ##    .
  .################.
  .################.
  .################.
  .################.
  .################.
  .################.
  .                .
  .                .
  .################.
  .################.
  .################.
  _################_

Char: 66 (/home/kraus/git/open-iconic/png/credit-card-2x.png), width: 16
  .                .
  .                .
  .################.
  .################.
  .                .
  .                .
  .################.
  .################.
  .################.
  .################.
  .##  ##  ########.
  .##  ##  ########.
  .################.
  .################.
  .                .
  _                _

Char: 67 (/home/kraus/git/open-iconic/png/key-2x.png), width: 16
  .         ####   .
  .       ######## .
  .       ####  ## .
  .      ####    ##.
  .      ####    ##.
  .      #####  ###.
  .     ###########.
  .    ########### .
  .   ############ .
  .   ##########   .
  .  ########      .
  . #########      .
  .######          .
  .######          .
  .######          .
  _######          _

Char: 68 (/home/kraus/git/open-iconic/png/lock-unlocked-2x.png), width: 16
  .      ####      .
  .     ######     .
  .    ###  ###    .
  .    ##    ##    .
  .          ##    .
  .          ##    .
  .          ##    .
  .          ##    .
  .  ############  .
  .  ############  .
  .  ############  .
  .  ############  .
  .  ############  .
  .  ############  .
  .  ############  .
  _  ############  _

Char: 69 (/home/kraus/git/open-iconic/png/paperclip-2x.png), width: 16
  .        ####    .
  .       ######   .
  .      ###  ###  .
  .     ###    ##  .
  .    ###     ##  .
  .   ###     ###  .
  .  ###     ###   .
  . ### ##  ###    .
  .### ### ###     .
  .##  ## ###      .
  .##  #####       .
  .##  #### ##     .
  .###     ###     .
  . ###   ###      .
  .  #######       .
  _   #####        _

Char: 70 (/home/kraus/git/open-iconic/png/puzzle-piece-2x.png), width: 16
  .     ##         .
  .    ####        .
  .    ####        .
  .     ##         .
  .############    .
  .############    .
  .############    .
  .############    .
  .############ ## .
  .################.
  .################.
  .############ ## .
  .#####  #####    .
  .####    ####    .
  .####    ####    .
  _#####  #####    _

Char: 71 (/home/kraus/git/open-iconic/png/brush-2x.png), width: 16
  .              # .
  .             ###.
  .           #### .
  .          ####  .
  .         #####  .
  .       ######   .
  .       #####    .
  .         ##     .
  .    ###  ##     .
  .   #####        .
  .   #####        .
  .   #####        .
  .  ######        .
  .  #####         .
  . #####          .
  _ ####           _

Char: 72 (/home/kraus/git/open-iconic/png/droplet-2x.png), width: 16
  .       #        .
  .       ##       .
  .      ####      .
  .     ######     .
  .    ########    .
  .    ########    .
  .   ##########   .
  .   ##########   .
  .  ############  .
  .  ############  .
  .  ##  ########  .
  .  ##  ########  .
  .  ###   ######  .
  .   ##    ####   .
  .    ########    .
  _     ######     _

Char: 73 (/home/kraus/git/open-iconic/png/laptop-2x.png), width: 16
  .                .
  .                .
  .  ############  .
  .  ############  .
  .  ##        ##  .
  .  ##        ##  .
  .  ##        ##  .
  .  ##        ##  .
  .  ##        ##  .
  .  ##        ##  .
  .######    ######.
  .######    ######.
  .################.
  .################.
  .                .
  _                _

Char: 74 (/home/kraus/git/open-iconic/png/magnifying-glass-2x.png), width: 16
  .    ######      .
  .   ########     .
  .  ###    ###    .
  . ##        ##   .
  .###        ###  .
  .##          ##  .
  .##          ##  .
  .##          ##  .
  .##          ##  .
  .###        ##   .
  . ##        ##   .
  .  ###    #####  .
  .   ############ .
  .    ###### #####.
  .            ####.
  _             ## _

Char: 75 (/home/kraus/git/open-iconic/png/phone-2x.png), width: 16
  .  ##########    .
  .  ##########    .
  .  ##      ##    .
  .  ##      ##    .
  .  ##      ##    .
  .  ##      ##    .
  .  ##      ##    .
  .  ##      ##    .
  .  ##      ##    .
  .  ##      ##    .
  .  ##      ##    .
  .  ##      ##    .
  .  ##########    .
  .  ####  ####    .
  .  ####  ####    .
  _  ##########    _

Char: 76 (/home/kraus/git/open-iconic/png/signpost-2x.png), width: 16
  .      ##        .
  .      ##        .
  .  ######        .
  . #######        .
  . ###########    .
  .  ###########   .
  .      #######   .
  .      ######    .
  .      ##        .
  .      ##        .
  .      ##        .
  .      ##        .
  .      ##        .
  .      ##        .
  .      ##        .
  _      ##        _

Char: 77 (/home/kraus/git/open-iconic/png/bug-2x.png), width: 16
  .      ###       .
  .     ####       .
  .    ######      .
  .    ######      .
  .##  ######  ##  .
  .##############  .
  .  ##########    .
  .   ########     .
  .######  ######  .
  .######  ######  .
  .  ####  ####    .
  .  ####  ####    .
  .######  ######  .
  .## ###  ### ##  .
  .    ##  ##      .
  _                _

Char: 78 (/home/kraus/git/open-iconic/png/fire-2x.png), width: 16
  .    #           .
  .    ##          .
  .    ###         .
  .    ###         .
  .   #####        .
  .  ######        .
  .  ######  #     .
  . #######  ##    .
  .#######   ###   .
  .######    ###   .
  .######   #####  .
  .#####   ######  .
  . ###    ######  .
  . ###   #######  .
  .  ##  ########  .
  _   #  #######   _

Char: 79 (/home/kraus/git/open-iconic/png/lock-locked-2x.png), width: 16
  .      ####      .
  .     ######     .
  .    ###  ###    .
  .    ##    ##    .
  .    ##    ##    .
  .    ##    ##    .
  .  ############  .
  .  ############  .
  .  ############  .
  .  ############  .
  .  ############  .
  .  ############  .
  .  ############  .
  .  ############  .
  .                .
  _                _

Char: 80 (/home/kraus/git/open-iconic/png/monitor-2x.png), width: 16
  .################.
  .################.
  .##            ##.
  .##            ##.
  .##            ##.
  .##            ##.
  .##            ##.
  .##            ##.
  .##            ##.
  .##            ##.
  .################.
  .################.
  .      ####      .
  .      ####      .
  .   ##########   .
  _  ############  _

Char: 81 (/home/kraus/git/open-iconic/png/pin-2x.png), width: 16
  .  ##########    .
  .  ##########    .
  .    ######      .
  .    ######      .
  .    ######      .
  .    ######      .
  . ############   .
  .##############  .
  .      ##        .
  .      ##        .
  .      ##        .
  .      ##        .
  .      ##        .
  .      ##        .
  .      ##        .
  _                _

Char: 82 (/home/kraus/git/open-iconic/png/tablet-2x.png), width: 16
  .##############  .
  .##############  .
  .##          ##  .
  .##          ##  .
  .##          ##  .
  .##          ##  .
  .##          ##  .
  .##          ##  .
  .##          ##  .
  .##          ##  .
  .##          ##  .
  .##          ##  .
  .##############  .
  .######  ######  .
  .######  ######  .
  _##############  _
