Font: open_iconic_app_4x (Symbols-bdf-sources/open_iconic_app_4x.bdf)
Declared name: "open_iconic_app_4x"
Declared family: None
Declared weight: None
Declared size: None
Matching characters: 9
Height: 32
Baseline: 32
Max width: 32
Fixed width: True

Char: 64 (/home/kraus/git/open-iconic/png/aperture-4x.png), width: 32
  .            ########            .
  .         ##############         .
  .         ###############        .
  .          ##############        .
  .            ############        .
  .    ##       ##########         .
  .   #####       ########    ##   .
  .   ######       #######    ##   .
  .  ########       #####    ####  .
  . ###########       ###    ##### .
  . ###########        ##    ##### .
  . ##########              ###### .
  .#########                #######.
  .########                 #######.
  .######                  ########.
  .#####                   ########.
  .####                    ########.
  .##                     #########.
  .#       #              #########.
  .      ###              #########.
  .     ####                       .
  .    ######                      .
  .  ########                      .
  .  ########                      .
  .   ########    ##############   .
  .   ########    ##############   .
  .    #######     ############    .
  .     #######    ###########     .
  .      ######    ##########      .
  .       #####     #######        .
  .         ####    ######         .
  _            #    ###            _

Char: 65 (/home/kraus/git/open-iconic/png/calculator-4x.png), width: 32
  .############################    .
  .############################    .
  .############################    .
  .############################    .
  .####                    ####    .
  .####                    ####    .
  .####                    ####    .
  .####                    ####    .
  .####                    ####    .
  .####                    ####    .
  .####                    ####    .
  .####                    ####    .
  .############################    .
  .############################    .
  .############################    .
  .############################    .
  .####    ####    ####    ####    .
  .####    ####    ####    ####    .
  .####    ####    ####    ####    .
  .####    ####    ####    ####    .
  .####################    ####    .
  .####################    ####    .
  .####################    ####    .
  .####################    ####    .
  .####    ####    ####    ####    .
  .####    ####    ####    ####    .
  .####    ####    ####    ####    .
  .####    ####    ####    ####    .
  .############################    .
  .############################    .
  .############################    .
  _############################    _

Char: 66 (/home/kraus/git/open-iconic/png/calendar-4x.png), width: 32
  .############################    .
  .############################    .
  .############################    .
  .############################    .
  .############################    .
  .############################    .
  .############################    .
  .############################    .
  .                                .
  .                                .
  .                                .
  .                                .
  .############################    .
  .############################    .
  .############################    .
  .############################    .
  .####    ####    ####    ####    .
  .####    ####    ####    ####    .
  .####    ####    ####    ####    .
  .####    ####    ####    ####    .
  .############################    .
  .############################    .
  .############################    .
  .############################    .
  .####    ####    ############    .
  .####    ####    ############    .
  .####    ####    ############    .
  .####    ####    ############    .
  .############################    .
  .############################    .
  .############################    .
  _############################    _

Char: 67 (/home/kraus/git/open-iconic/png/camera-slr-4x.png), width: 32
  .                ########        .
  .               ##########       .
  .               ##########       .
  .              ############      .
  .              ############      .
  .             ##############     .
  .             ##############     .
  .            ################    .
  .   #############################.
  .  ##############################.
  . ###############################.
  .################################.
  .#####  ##########      #########.
  .####    #######          #######.
  .####    ######            ######.
  .#####  ######              #####.
  .#############     ####     #####.
  .############     ######     ####.
  .############    ########    ####.
  .############    ########    ####.
  .############    ########    ####.
  .############    ########    ####.
  .############     ######     ####.
  .#############     ####     #####.
  .#############              #####.
  .##############            ######.
  .###############          #######.
  .#################      #########.
  .################################.
  .################################.
  .################################.
  _################################_

Char: 68 (/home/kraus/git/open-iconic/png/chat-4x.png), width: 32
  .####################            .
  .####################            .
  .####################            .
  .####################            .
  .########                        .
  .########                        .
  .########                        .
  .########                        .
  .########    ####################.
  .########    ####################.
  .########    ####################.
  .########    ####################.
  .########    ####################.
  .########    ####################.
  .########    ####################.
  .########    ####################.
  .###         ####################.
  .##          ####################.
  .#           ####################.
  .            ####################.
  .            ####################.
  .            ####################.
  .            ####################.
  .            ####################.
  .                             ###.
  .                              ##.
  .                               #.
  .                                .
  .                                .
  .                                .
  .                                .
  _                                _

Char: 69 (/home/kraus/git/open-iconic/png/clock-4x.png), width: 32
  .            ########            .
  .         ##############         .
  .       ##################       .
  .      ####################      .
  .     ########      ########     .
  .    ######            ######    .
  .   ######              ######   .
  .  ######                ######  .
  .  #####       ####       #####  .
  . #####        ####        ##### .
  . ####         ####         #### .
  . ####         ####         #### .
  .#####         ####         #####.
  .####          ####          ####.
  .####          ####          ####.
  .####          ####          ####.
  .####          #####         ####.
  .####           #####        ####.
  .####            ####        ####.
  .#####            ##        #####.
  . ####                      #### .
  . ####                      #### .
  . #####                    ##### .
  .  #####                  #####  .
  .  ######                ######  .
  .   ######              ######   .
  .    ######            ######    .
  .     ########      ########     .
  .      ####################      .
  .       ##################       .
  .         ##############         .
  _            ########            _

Char: 70 (/home/kraus/git/open-iconic/png/compass-4x.png), width: 32
  .            ########            .
  .         ##############         .
  .       ##################       .
  .      ####################      .
  .     ########      ########     .
  .    ######            ######    .
  .   ######              ######   .
  .  ######                ######  .
  .  #####                # #####  .
  . #####              ###   ##### .
  . ####            ######    #### .
  . ####         #########    #### .
  .#####       ##########     #####.
  .####        ##########      ####.
  .####       ####  #####      ####.
  .####       ###    ###       ####.
  .####       ###    ###       ####.
  .####      #####  ####       ####.
  .####      ##########        ####.
  .#####     ##########       #####.
  . ####    #########         #### .
  . ####    ######            #### .
  . #####   ###              ##### .
  .  ##### #                #####  .
  .  ######                ######  .
  .   ######              ######   .
  .    ######            ######    .
  .     ########      ########     .
  .      ####################      .
  .       ##################       .
  .         ##############         .
  _            ########            _

Char: 71 (/home/kraus/git/open-iconic/png/shield-4x.png), width: 32
  .               ##               .
  .             ######             .
  .          ############          .
  .        ################        .
  .     ######################     .
  .   ##########   #############   .
  . ##########     ############### .
  .########        ################.
  .######          ################.
  .####            ################.
  .####            ################.
  .####            ################.
  .#####           ################.
  . ####           ############### .
  . ####           ############### .
  . ####           ############### .
  . #####          ############### .
  .  ####          ##############  .
  .  #####         ##############  .
  .   ####         #############   .
  .   #####        #############   .
  .    ####        ############    .
  .    #####       ############    .
  .     #####      ###########     .
  .      #####     ##########      .
  .      ######    ##########      .
  .       ######   #########       .
  .        ####### ########        .
  .         ##############         .
  .          ############          .
  .            ########            .
  _              ####              _

Char: 72 (/home/kraus/git/open-iconic/png/timer-4x.png), width: 32
  .        ############            .
  .        ############            .
  .        ############            .
  .        ############            .
  .          #######               .
  .        ###########             .
  .      ############              .
  .     #############      ##      .
  .    #######            ##       .
  .   ######             ##        .
  .  #####             ###         .
  .  ####             ###          .
  . #####            ###           .
  . ####            ###      #     .
  .#####          #####    ###     .
  .####          #####     ####    .
  .####         #####      ####    .
  .####        #####       ####    .
  .####        ####        ####    .
  .####         ##         ####    .
  .####                    ####    .
  .#####                  #####    .
  . ####                  ####     .
  . #####                #####     .
  .  ####                ####      .
  .  #####              #####      .
  .   ######          ######       .
  .    #######      #######        .
  .     ##################         .
  .      ################          .
  .        ############            .
  _          ########              _
