Font: open_iconic_play_2x (Symbols-bdf-sources/open_iconic_play_2x.bdf)
Declared name: open_iconic_play_2x
Declared family: iconic
Declared weight: none
Declared size: None
Characters: 18
Height: 16
Baseline: 16
Max width: 16
Fixed width: True

Char 64 (/home/kraus/git/open-iconic/png/audio-spectrum-2x.png), width 16
  .        ##      . 
  .        ##      . 
  .    ##  ##      . 
  .    ##  ##      . 
  .    ##  ##  ##  . 
  .    ##  ##  ##  . 
  .##  ##  ##  ##  . 
  .##  ##  ##  ##  . 
  .##  ##  ##  ##  . 
  .##  ##  ##  ##  . 
  .    ##  ##  ##  . 
  .    ##  ##  ##  . 
  .    ##  ##      . 
  .    ##  ##      . 
  .        ##      . 
  .        ##      . 

Char 65 (/home/kraus/git/open-iconic/png/bullhorn-2x.png), width 16
  .            ##  . 
  .         #  ##  . 
  .       ###  ##  . 
  .     #####  ##  . 
  .##########  ##  . 
  .##########  ##  . 
  .##########  ##  . 
  .##########  ##  . 
  .  ########  ##  . 
  .   ##  ###  ##  . 
  .   ##    #  ##  . 
  .   ##       ##  . 
  .    ##          . 
  .    ##          . 
  .                . 
  .                . 

Char 66 (/home/kraus/git/open-iconic/png/eject-2x.png), width 16
  .                . 
  .       ##       . 
  .      ####      . 
  .     ######     . 
  .    ########    . 
  .    ########    . 
  .   ##########   . 
  .  ############  . 
  . ############## . 
  .################. 
  .                . 
  .                . 
  .################. 
  .################. 
  .################. 
  .################. 

Char 67 (/home/kraus/git/open-iconic/png/headphones-2x.png), width 16
  .      ####      . 
  .    ########    . 
  .   ###    ###   . 
  .   ##      ##   . 
  .  ##        ##  . 
  .  ##        ##  . 
  .  ##        ##  . 
  .  ##        ##  . 
  .####        ####. 
  .####        ####. 
  .####        ####. 
  .####        ####. 
  .####        ####. 
  .####        ####. 
  .                . 
  .                . 

Char 68 (/home/kraus/git/open-iconic/png/media-pause-2x.png), width 16
  .                . 
  .                . 
  .  ####    ####  . 
  .  ####    ####  . 
  .  ####    ####  . 
  .  ####    ####  . 
  .  ####    ####  . 
  .  ####    ####  . 
  .  ####    ####  . 
  .  ####    ####  . 
  .  ####    ####  . 
  .  ####    ####  . 
  .  ####    ####  . 
  .  ####    ####  . 
  .                . 
  .                . 

Char 69 (/home/kraus/git/open-iconic/png/media-play-2x.png), width 16
  .                . 
  .                . 
  .  #             . 
  .  ###           . 
  .  #####         . 
  .  #######       . 
  .  #########     . 
  .  ###########   . 
  .  ###########   . 
  .  #########     . 
  .  #######       . 
  .  #####         . 
  .  ###           . 
  .  #             . 
  .                . 
  .                . 

Char 70 (/home/kraus/git/open-iconic/png/media-record-2x.png), width 16
  .                . 
  .                . 
  .      ####      . 
  .    ########    . 
  .   ##########   . 
  .   ##########   . 
  .  ############  . 
  .  ############  . 
  .  ############  . 
  .  ############  . 
  .   ##########   . 
  .   ##########   . 
  .    ########    . 
  .      ####      . 
  .                . 
  .                . 

Char 71 (/home/kraus/git/open-iconic/png/media-skip-backward-2x.png), width 16
  .                . 
  .                . 
  .       #       #. 
  .      ##      ##. 
  .     ###     ###. 
  .   #####   #####. 
  .  ######  ######. 
  . ####### #######. 
  . ####### #######. 
  .  ######  ######. 
  .   #####   #####. 
  .     ###     ###. 
  .      ##      ##. 
  .       #       #. 
  .                . 
  .                . 

Char 72 (/home/kraus/git/open-iconic/png/media-skip-forward-2x.png), width 16
  .                . 
  .                . 
  .#       #       . 
  .##      ##      . 
  .###     ###     . 
  .#####   #####   . 
  .######  ######  . 
  .####### ####### . 
  .####### ####### . 
  .######  ######  . 
  .#####   #####   . 
  .###     ###     . 
  .##      ##      . 
  .#       #       . 
  .                . 
  .                . 

Char 73 (/home/kraus/git/open-iconic/png/media-step-backward-2x.png), width 16
  .                . 
  .                . 
  .####         #  . 
  .####        ##  . 
  .####      ####  . 
  .####    ######  . 
  .####   #######  . 
  .#### #########  . 
  .#### #########  . 
  .####   #######  . 
  .####    ######  . 
  .####      ####  . 
  .####        ##  . 
  .####         #  . 
  .                . 
  .                . 

Char 74 (/home/kraus/git/open-iconic/png/media-step-forward-2x.png), width 16
  .                . 
  .                . 
  .#         ####  . 
  .##        ####  . 
  .####      ####  . 
  .######    ####  . 
  .#######   ####  . 
  .######### ####  . 
  .######### ####  . 
  .#######   ####  . 
  .######    ####  . 
  .####      ####  . 
  .##        ####  . 
  .#         ####  . 
  .                . 
  .                . 

Char 75 (/home/kraus/git/open-iconic/png/media-stop-2x.png), width 16
  .                . 
  .                . 
  .  ############  . 
  .  ############  . 
  .  ############  . 
  .  ############  . 
  .  ############  . 
  .  ############  . 
  .  ############  . 
  .  ############  . 
  .  ############  . 
  .  ############  . 
  .  ############  . 
  .  ############  . 
  .                . 
  .                . 

Char 76 (/home/kraus/git/open-iconic/png/microphone-2x.png), width 16
  .       ##       . 
  .      ####      . 
  .      ####      . 
  .      ####      . 
  .  ##  ####  ##  . 
  .  ##  ####  ##  . 
  .  ##  ####  ##  . 
  .  ##   ##   ##  . 
  .   ##      ##   . 
  .   ###    ###   . 
  .    ########    . 
  .      ####      . 
  .       ##       . 
  .       ##       . 
  .     ######     . 
  .    ########    . 

Char 77 (/home/kraus/git/open-iconic/png/musical-note-2x.png), width 16
  .         #######. 
  .     ###########. 
  .    ############. 
  .    ############. 
  .    ####      ##. 
  .    ##        ##. 
  .    ##        ##. 
  .    ##        ##. 
  .    ##     #####. 
  .    ##    ######. 
  . #####    ######. 
  .######    ######. 
  .######    ######. 
  .######     #### . 
  .######          . 
  . ####           . 

Char 78 (/home/kraus/git/open-iconic/png/play-circle-2x.png), width 16
  .     ######     . 
  .   ##########   . 
  .  ############  . 
  . ############## . 
  . ##### ######## . 
  .######  ########. 
  .######    ######. 
  .######     #####. 
  .######     #####. 
  .######    ######. 
  .######  ########. 
  . ##### ######## . 
  . ############## . 
  .  ############  . 
  .   ##########   . 
  .     ######     . 

Char 79 (/home/kraus/git/open-iconic/png/volume-high-2x.png), width 16
  .      ##        . 
  .      ##        . 
  .     ###  ##    . 
  .    ####  ####  . 
  .########    ### . 
  .########     ## . 
  .########  #   ##. 
  .########  ##  ##. 
  .########  ##  ##. 
  .########  #   ##. 
  .########     ## . 
  .########    ### . 
  .    ####  ####  . 
  .     ###  ##    . 
  .      ##        . 
  .      ##        . 

Char 80 (/home/kraus/git/open-iconic/png/volume-low-2x.png), width 16
  .        ##      . 
  .        ##      . 
  .       ###      . 
  .      ####      . 
  .  ########      . 
  .  ########      . 
  .  ########  #   . 
  .  ########  ##  . 
  .  ########  ##  . 
  .  ########  #   . 
  .  ########      . 
  .  ########      . 
  .      ####      . 
  .       ###      . 
  .        ##      . 
  .        ##      . 

Char 81 (/home/kraus/git/open-iconic/png/volume-off-2x.png), width 16
  .          ##    . 
  .          ##    . 
  .         ###    . 
  .        ####    . 
  .    ########    . 
  .    ########    . 
  .    ########    . 
  .    ########    . 
  .    ########    . 
  .    ########    . 
  .    ########    . 
  .    ########    . 
  .        ####    . 
  .         ###    . 
  .          ##    . 
  .          ##    . 
