Font: open_iconic_other_4x (Symbols-bdf-sources/open_iconic_other_4x.bdf)
Declared name: open_iconic_other_4x
Declared family: iconic
Declared weight: none
Declared size: None
Characters: 8
Height: 32
Baseline: 32
Max width: 32
Fixed width: True

Char 64 (/home/kraus/git/open-iconic/png/bolt-4x.png), width 32
  .                                . 
  .               #                . 
  .               #                . 
  .              ##                . 
  .             ###                . 
  .             ###                . 
  .            ####                . 
  .            ####                . 
  .           #####                . 
  .          ######                . 
  .          ######                . 
  .         #######                . 
  .         ###############        . 
  .        ###############         . 
  .       ###############          . 
  .       ###############          . 
  .      ###############           . 
  .      ###############           . 
  .     ###############            . 
  .    ###############             . 
  .            #######             . 
  .            ######              . 
  .            ######              . 
  .            #####               . 
  .            ####                . 
  .            ####                . 
  .            ###                 . 
  .            ###                 . 
  .            ##                  . 
  .            #                   . 
  .            #                   . 
 __                                __

Char 65 (/home/kraus/git/open-iconic/png/dial-4x.png), width 32
  .                                . 
  .                                . 
  .                                . 
  .                                . 
  .            ########            . 
  .         ##############         . 
  .       ##################       . 
  .      ####################      . 
  .     ########      ########     . 
  .    ######            ######    . 
  .   ######              ######   . 
  .  ######                ######  . 
  .  #####                  #####  . 
  . #####     ###    ###     ##### . 
  . ####     #####  #####     #### . 
  . ####    ##############    #### . 
  .#####    ##############    #####. 
  .####    ################    ####. 
  .####    ################    ####. 
  .####    ################    ####. 
  .        ################        . 
  .        ################        . 
  .        ################        . 
  .         ##############         . 
  .         ##############         . 
  .          ############          . 
  .           ##########           . 
  .             ######             . 
  .                                . 
  .                                . 
  .                                . 
 __                                __

Char 66 (/home/kraus/git/open-iconic/png/fork-4x.png), width 32
  .    ####            ####        . 
  .  ########        ########      . 
  . ##########      ##########     . 
  . ##########      ##########     . 
  .############    ############    . 
  .############    ############    . 
  .############    ############    . 
  .############    ############    . 
  . ##########      ##########     . 
  . ##########      ##########     . 
  .  ########        ########      . 
  .    ####            ####        . 
  .    ####            ####        . 
  .    ####            ####        . 
  .    ####            ####        . 
  .    ####           #####        . 
  .    ###################         . 
  .    ###################         . 
  .    ##################          . 
  .    ################            . 
  .    #####                       . 
  .  ########                      . 
  . ##########                     . 
  . ##########                     . 
  .############                    . 
  .############                    . 
  .############                    . 
  .############                    . 
  . ##########                     . 
  . ##########                     . 
  .  ########                      . 
 __    ####                        __

Char 67 (/home/kraus/git/open-iconic/png/grid-four-up-4x.png), width 32
  .####    ####    ####    ####    . 
  .####    ####    ####    ####    . 
  .####    ####    ####    ####    . 
  .####    ####    ####    ####    . 
  .                                . 
  .                                . 
  .                                . 
  .                                . 
  .####    ####    ####    ####    . 
  .####    ####    ####    ####    . 
  .####    ####    ####    ####    . 
  .####    ####    ####    ####    . 
  .                                . 
  .                                . 
  .                                . 
  .                                . 
  .####    ####    ####    ####    . 
  .####    ####    ####    ####    . 
  .####    ####    ####    ####    . 
  .####    ####    ####    ####    . 
  .                                . 
  .                                . 
  .                                . 
  .                                . 
  .####    ####    ####    ####    . 
  .####    ####    ####    ####    . 
  .####    ####    ####    ####    . 
  .####    ####    ####    ####    . 
  .                                . 
  .                                . 
  .                                . 
 __                                __

Char 68 (/home/kraus/git/open-iconic/png/grid-three-up-4x.png), width 32
  .########    ########    ########. 
  .########    ########    ########. 
  .########    ########    ########. 
  .########    ########    ########. 
  .########    ########    ########. 
  .########    ########    ########. 
  .########    ########    ########. 
  .########    ########    ########. 
  .                                . 
  .                                . 
  .                                . 
  .                                . 
  .########    ########    ########. 
  .########    ########    ########. 
  .########    ########    ########. 
  .########    ########    ########. 
  .########    ########    ########. 
  .########    ########    ########. 
  .########    ########    ########. 
  .########    ########    ########. 
  .                                . 
  .                                . 
  .                                . 
  .                                . 
  .########    ########    ########. 
  .########    ########    ########. 
  .########    ########    ########. 
  .########    ########    ########. 
  .########    ########    ########. 
  .########    ########    ########. 
  .########    ########    ########. 
 __########    ########    ########__

Char 69 (/home/kraus/git/open-iconic/png/grid-two-up-4x.png), width 32
  .############        ############. 
  .############        ############. 
  .############        ############. 
  .############        ############. 
  .############        ############. 
  .############        ############. 
  .############        ############. 
  .############        ############. 
  .############        ############. 
  .############        ############. 
  .############        ############. 
  .############        ############. 
  .                                . 
  .                                . 
  .                                . 
  .                                . 
  .                                . 
  .                                . 
  .                                . 
  .                                . 
  .############        ############. 
  .############        ############. 
  .############        ############. 
  .############        ############. 
  .############        ############. 
  .############        ############. 
  .############        ############. 
  .############        ############. 
  .############        ############. 
  .############        ############. 
  .############        ############. 
 __############        ############__

Char 70 (/home/kraus/git/open-iconic/png/signal-4x.png), width 32
  .                        ####    . 
  .                        ####    . 
  .                        ####    . 
  .                        ####    . 
  .                ####    ####    . 
  .                ####    ####    . 
  .                ####    ####    . 
  .                ####    ####    . 
  .                ####    ####    . 
  .                ####    ####    . 
  .                ####    ####    . 
  .                ####    ####    . 
  .        ####    ####    ####    . 
  .        ####    ####    ####    . 
  .        ####    ####    ####    . 
  .        ####    ####    ####    . 
  .        ####    ####    ####    . 
  .        ####    ####    ####    . 
  .        ####    ####    ####    . 
  .        ####    ####    ####    . 
  .####    ####    ####    ####    . 
  .####    ####    ####    ####    . 
  .####    ####    ####    ####    . 
  .####    ####    ####    ####    . 
  .####    ####    ####    ####    . 
  .####    ####    ####    ####    . 
  .####    ####    ####    ####    . 
  .####    ####    ####    ####    . 
  .####    ####    ####    ####    . 
  .####    ####    ####    ####    . 
  .####    ####    ####    ####    . 
 __####    ####    ####    ####    __

Char 71 (/home/kraus/git/open-iconic/png/target-4x.png), width 32
  .            ########            . 
  .         ##############         . 
  .       ##################       . 
  .      ####################      . 
  .     ########      ########     . 
  .    ######            ######    . 
  .   ######              ######   . 
  .  ######                ######  . 
  .  #####      ######      #####  . 
  . #####     ##########     ##### . 
  . ####     ############     #### . 
  . ####    ##############    #### . 
  .#####    #####    #####    #####. 
  .####    #####      #####    ####. 
  .####    ####        ####    ####. 
  .####    ####        ####    ####. 
  .####    ####        ####    ####. 
  .####    ####        ####    ####. 
  .####    #####      #####    ####. 
  .#####    #####    #####    #####. 
  . ####    ##############    #### . 
  . ####     ############     #### . 
  . #####     ##########     ##### . 
  .  #####      ######      #####  . 
  .  ######                ######  . 
  .   ######              ######   . 
  .    ######            ######    . 
  .     ########      ########     . 
  .      ####################      . 
  .       ##################       . 
  .         ##############         . 
 __            ########            __
