Font: open_iconic_human_2x (Symbols-bdf-sources/open_iconic_human_2x.bdf)
Declared name: open_iconic_human_2x
Declared family: iconic
Declared weight: none
Declared size: None
Characters: 5
Height: 16
Baseline: 16
Max width: 16
Fixed width: True

Char 64 (/home/kraus/git/open-iconic/png/eye-2x.png), width 16
  .                . 
  .                . 
  .      ####      . 
  .    ########    . 
  .   ###    ###   . 
  .  ###      ###  . 
  . ###   #    ### . 
  .####  ##    ####. 
  .####  ####  ####. 
  . ###   ##   ### . 
  .  ###      ###  . 
  .   ###    ###   . 
  .    ########    . 
  .      ####      . 
  .                . 
  .                . 

Char 65 (/home/kraus/git/open-iconic/png/eyedropper-2x.png), width 16
  .      ##   #### . 
  .      ### ######. 
  .       #########. 
  .       #########. 
  .      ##########. 
  .     ###  ##### . 
  .    ###    ###  . 
  .   ###     #### . 
  .  ###     ######. 
  . ###     ###  ##. 
  .###     ###     . 
  .###    ###      . 
  .####  ###       . 
  .########        . 
  .#######         . 
  .######          . 

Char 66 (/home/kraus/git/open-iconic/png/heart-2x.png), width 16
  .                . 
  .                . 
  .  ####    ####  . 
  . ######  ###### . 
  .################. 
  .################. 
  .################. 
  .################. 
  . ############## . 
  .  ############  . 
  .   ##########   . 
  .    ########    . 
  .     ######     . 
  .      ####      . 
  .       ##       . 
  .                . 

Char 67 (/home/kraus/git/open-iconic/png/people-2x.png), width 16
  .          ##    . 
  .         ####   . 
  .    ##   #####  . 
  .   ####   ####  . 
  .  ######  ####  . 
  .  ######  ####  . 
  .  ######  ###   . 
  .  ######  ##    . 
  .   ####         . 
  .    ##       ###. 
  .           #####. 
  .###    ###  ####. 
  .##########  ####. 
  .##########  ####. 
  .##########      . 
  .##########      . 

Char 68 (/home/kraus/git/open-iconic/png/person-2x.png), width 16
  .      ####      . 
  .     ######     . 
  .     ######     . 
  .    ########    . 
  .    ########    . 
  .    ########    . 
  .    ########    . 
  .     ######     . 
  .     ######     . 
  .      ####      . 
  .  ##        ##  . 
  . #####    ##### . 
  .################. 
  .################. 
  .################. 
  .################. 
