Font: open_iconic_email_2x (Symbols-bdf-sources/open_iconic_email_2x.bdf)
Declared name: open_iconic_email_2x
Declared family: iconic
Declared weight: none
Declared size: None
Characters: 5
Height: 16
Baseline: 16
Max width: 16
Fixed width: True

Char 64 (/home/kraus/git/open-iconic/png/envelope-closed-2x.png), width 16
  .                . 
  .                . 
  .################. 
  .################. 
  . ############## . 
  .   ##########   . 
  .#    ######    #. 
  .###    ##    ###. 
  .#####      #####. 
  .#######  #######. 
  .################. 
  .################. 
  .################. 
  .################. 
  .                . 
 __                __

Char 65 (/home/kraus/git/open-iconic/png/envelope-open-2x.png), width 16
  .       ##       . 
  .     ######     . 
  .   ####  ####   . 
  . ####      #### . 
  .###          ###. 
  .##            ##. 
  .##  ########  ##. 
  .##  ########  ##. 
  .##   ######   ##. 
  .###    ##    ###. 
  .#####      #####. 
  .#######  #######. 
  .################. 
  .################. 
  .################. 
 __################__

Char 66 (/home/kraus/git/open-iconic/png/inbox-2x.png), width 16
  .################. 
  .################. 
  .################. 
  .################. 
  .##            ##. 
  .##            ##. 
  .##            ##. 
  .##            ##. 
  .##            ##. 
  .##            ##. 
  .####        ####. 
  .#####      #####. 
  .################. 
  .################. 
  .################. 
 __################__

Char 67 (/home/kraus/git/open-iconic/png/tag-2x.png), width 16
  .######          . 
  .#######         . 
  .###  ###        . 
  .##    ###       . 
  .##    ####      . 
  .###  ######     . 
  . ###########    . 
  .  ###########   . 
  .   ###########  . 
  .    ########### . 
  .     ########## . 
  .      ########  . 
  .       ######   . 
  .        ####    . 
  .         ##     . 
 __                __

Char 68 (/home/kraus/git/open-iconic/png/tags-2x.png), width 16
  .                . 
  .                . 
  .####   ###      . 
  .#####   ###     . 
  .##  ##   ###    . 
  .##  ###   ###   . 
  . #######   ###  . 
  .  #######   ### . 
  .   ######   ### . 
  .    ####   ###  . 
  .     ##    ##   . 
  .                . 
  .                . 
  .                . 
  .                . 
 __                __
