Font: open_iconic_weather_6x (Symbols-bdf-sources/open_iconic_weather_6x.bdf)
Declared name: open_iconic_weather_6x
Declared family: iconic
Declared weight: none
Declared size: None
Characters: 6
Height: 48
Baseline: 48
Max width: 48
Fixed width: True

Char 64 (/home/kraus/git/open-iconic/png/cloud-6x.png), width 48
  .                                                . 
  .                                                . 
  .                                                . 
  .                                                . 
  .                                                . 
  .                                                . 
  .                       ########                 . 
  .                    #############               . 
  .                   ################             . 
  .                 ####################           . 
  .                ######################          . 
  .               ########################         . 
  .              #########################         . 
  .              ##########################        . 
  .             ###########################        . 
  .             ############################       . 
  .            #############################       . 
  .            ##############################      . 
  .         #################################      . 
  .      ####################################      . 
  .     #####################################      . 
  .    ######################################      . 
  .   #######################################      . 
  .  ########################################      . 
  . ##########################################     . 
  . ############################################   . 
  . #############################################  . 
  .##############################################  . 
  .############################################### . 
  .############################################### . 
  .################################################. 
  .################################################. 
  .################################################. 
  . ###############################################. 
  . ###############################################. 
  . ###############################################. 
  .  ############################################# . 
  .   ############################################ . 
  .    ##########################################  . 
  .     ########################################   . 
  .      ######################################    . 
  .         #################################      . 
  .                                                . 
  .                                                . 
  .                                                . 
  .                                                . 
  .                                                . 
 __                                                __

Char 65 (/home/kraus/git/open-iconic/png/cloudy-6x.png), width 48
  .           ########                             . 
  .        #############                           . 
  .       ################                         . 
  .     ####################                       . 
  .    ######################                      . 
  .   ########################                     . 
  .   ###################                          . 
  .  #################                             . 
  . ################                               . 
  . ##############                                 . 
  . #############                                  . 
  .#############                                   . 
  .############           ########                 . 
  .###########         #############               . 
  .##########         ################             . 
  .#########        ####################           . 
  .#########       ######################          . 
  .########       ########################         . 
  .#######       #########################         . 
  . ####         ##########################        . 
  . ##          ###########################        . 
  .             ############################       . 
  .            #############################       . 
  .            ##############################      . 
  .         #################################      . 
  .      ####################################      . 
  .     #####################################      . 
  .    ######################################      . 
  .   #######################################      . 
  .  ########################################      . 
  . ##########################################     . 
  . ############################################   . 
  . #############################################  . 
  .##############################################  . 
  .############################################### . 
  .############################################### . 
  .################################################. 
  .################################################. 
  .################################################. 
  . ###############################################. 
  . ###############################################. 
  . ###############################################. 
  .  ############################################# . 
  .   ############################################ . 
  .    ##########################################  . 
  .     ########################################   . 
  .      ######################################    . 
 __         #################################      __

Char 66 (/home/kraus/git/open-iconic/png/moon-6x.png), width 48
  .               #                                . 
  .             ###                                . 
  .           #####                                . 
  .          #####                                 . 
  .        #######                                 . 
  .       ########                                 . 
  .      #########                                 . 
  .     ##########                                 . 
  .     ##########                                 . 
  .    ###########                                 . 
  .   ############                                 . 
  .   ############                                 . 
  .  #############                                 . 
  .  ##############                                . 
  . ###############                                . 
  . ###############                                . 
  . ################                               . 
  . ################                               . 
  .##################                              . 
  .##################                              . 
  .###################                             . 
  .###################                             . 
  .####################                            . 
  .#####################                           . 
  .######################                          . 
  .#######################                         . 
  .########################                        . 
  .#########################                       . 
  . ##########################                     . 
  . ############################                   . 
  . ###############################                . 
  .  ##################################      ####  . 
  .  ############################################  . 
  .   ##########################################   . 
  .   ##########################################   . 
  .    ########################################    . 
  .    ########################################    . 
  .     ######################################     . 
  .      ####################################      . 
  .       ##################################       . 
  .        ################################        . 
  .         ##############################         . 
  .           ##########################           . 
  .            ########################            . 
  .              ####################              . 
  .                 ##############                 . 
  .                     ######                     . 
 __                                                __

Char 67 (/home/kraus/git/open-iconic/png/rain-6x.png), width 48
  .                       ########                 . 
  .                    ##############              . 
  .                   ################             . 
  .                 ####################           . 
  .                ######################          . 
  .               ########################         . 
  .              #########################         . 
  .              ##########################        . 
  .             ############################       . 
  .             ############################       . 
  .            #############################       . 
  .            ##############################      . 
  .         #################################      . 
  .      ####################################      . 
  .     #####################################      . 
  .    ######################################      . 
  .   #######################################      . 
  .  ########################################      . 
  . ##########################################     . 
  . ############################################   . 
  . #############################################  . 
  .##############################################  . 
  .############################################### . 
  .############################################### . 
  .##################      ########################. 
  .################          ######################. 
  .###############            #####################. 
  . #############              ####################. 
  . ############                ###################. 
  . ############                ###################. 
  .  ####             ####             ########### . 
  .   #              ######              ######### . 
  .                  ######               #######  . 
  .                  ######                #####   . 
  .                  ######                 ###    . 
  .                  ######                        . 
  .       ####       ######       ####             . 
  .      ######      ######      ######            . 
  .      ######      ######      ######            . 
  .      ######      ######      ######            . 
  .      ######      ######      ######            . 
  .      ######      ######      ######            . 
  .      ######      ######      ######            . 
  .      ######      ######      ######            . 
  .      ######      ######      ######            . 
  .      ######      ######      ######            . 
  .      ######      ######      ######            . 
 __       ####        ####        ####             __

Char 68 (/home/kraus/git/open-iconic/png/star-6x.png), width 48
  .                                                . 
  .                                                . 
  .                       ##                       . 
  .                       ##                       . 
  .                       ##                       . 
  .                      ####                      . 
  .                      ####                      . 
  .                      ####                      . 
  .                     ######                     . 
  .                     ######                     . 
  .                     ######                     . 
  .                    ########                    . 
  .                    ########                    . 
  .                    ########                    . 
  .                   ##########                   . 
  .                   ##########                   . 
  .                   ##########                   . 
  .                  ############                  . 
  . ############################################## . 
  .  ############################################  . 
  .   ##########################################   . 
  .    ########################################    . 
  .      ####################################      . 
  .       ##################################       . 
  .        ################################        . 
  .         ##############################         . 
  .           ##########################           . 
  .            ########################            . 
  .             ######################             . 
  .              ####################              . 
  .               ##################               . 
  .               ##################               . 
  .              ####################              . 
  .              ####################              . 
  .              ####################              . 
  .             ######################             . 
  .             ##########  ##########             . 
  .             #########    #########             . 
  .            #########      #########            . 
  .            ########        ########            . 
  .            ######            ######            . 
  .           ######              ######           . 
  .           #####                #####           . 
  .           ####                  ####           . 
  .          ###                      ###          . 
  .          ##                        ##          . 
  .          #                          #          . 
 __                                                __

Char 69 (/home/kraus/git/open-iconic/png/sun-6x.png), width 48
  .                      ####                      . 
  .                     ######                     . 
  .                     ######                     . 
  .                     ######                     . 
  .                     ######                     . 
  .                      ####                      . 
  .       ####                          ####       . 
  .      ######                        ######      . 
  .      ######                        ######      . 
  .      ######                        ######      . 
  .      ######                        ######      . 
  .       ####                          ####       . 
  .                     ######                     . 
  .                  ############                  . 
  .                 ##############                 . 
  .                ################                . 
  .               ##################               . 
  .              ####################              . 
  .             ######################             . 
  .             ######################             . 
  .             ######################             . 
  . ####       ########################       #### . 
  .######      ########################      ######. 
  .######      ########################      ######. 
  .######      ########################      ######. 
  .######      ########################      ######. 
  . ####       ########################       #### . 
  .             ######################             . 
  .             ######################             . 
  .             ######################             . 
  .              ####################              . 
  .               ##################               . 
  .                ################                . 
  .                 ##############                 . 
  .                  ############                  . 
  .                     ######                     . 
  .       ####                          ####       . 
  .      ######                        ######      . 
  .      ######                        ######      . 
  .      ######                        ######      . 
  .      ######                        ######      . 
  .       ####                          ####       . 
  .                      ####                      . 
  .                     ######                     . 
  .                     ######                     . 
  .                     ######                     . 
  .                     ######                     . 
 __                      ####                      __
