Font: open_iconic_check_4x (Symbols-bdf-sources/open_iconic_check_4x.bdf)
Declared name: open_iconic_check_4x
Declared family: iconic
Declared weight: none
Declared size: None
Characters: 5
Height: 32
Baseline: 32
Max width: 32
Fixed width: True

Char 64 (/home/kraus/git/open-iconic/png/check-4x.png), width 32
  .                                . 
  .                                . 
  .                                . 
  .                                . 
  .                         #      . 
  .                        ###     . 
  .                       #####    . 
  .                      #######   . 
  .                     #########  . 
  .                    ########### . 
  .                   ############ . 
  .                  ############  . 
  .     #           ############   . 
  .    ###         ############    . 
  .   #####       ############     . 
  .  #######     ############      . 
  . #########   ############       . 
  .########### ############        . 
  . ######################         . 
  .  ####################          . 
  .   ##################           . 
  .    ################            . 
  .     ##############             . 
  .      ############              . 
  .       ##########               . 
  .        ########                . 
  .         ######                 . 
  .          ####                  . 
  .           ##                   . 
  .                                . 
  .                                . 
 __                                __

Char 65 (/home/kraus/git/open-iconic/png/circle-check-4x.png), width 32
  .            ########            . 
  .         ##############         . 
  .       ##################       . 
  .      ####################      . 
  .     ######################     . 
  .    ########################    . 
  .   ##########################   . 
  .  ############################  . 
  .  #####################  #####  . 
  . #####################    ##### . 
  . ####################     ##### . 
  . ###################     ###### . 
  .###################     ########. 
  .##################     #########. 
  .#########  ######     ##########. 
  .########    ####     ###########. 
  .########     ##     ############. 
  .#########          #############. 
  .##########        ##############. 
  .###########      ###############. 
  . ###########    ############### . 
  . ############  ################ . 
  . ############################## . 
  .  ############################  . 
  .  ############################  . 
  .   ##########################   . 
  .    ########################    . 
  .     ######################     . 
  .      ####################      . 
  .       ##################       . 
  .         ##############         . 
 __            ########            __

Char 66 (/home/kraus/git/open-iconic/png/circle-x-4x.png), width 32
  .            ########            . 
  .         ##############         . 
  .       ##################       . 
  .      ####################      . 
  .     ######################     . 
  .    ########################    . 
  .   ##########################   . 
  .  ############################  . 
  .  #######  ##########  #######  . 
  . #######    ########    ####### . 
  . #######     ######     ####### . 
  . ########     ####     ######## . 
  .##########     ##     ##########. 
  .###########          ###########. 
  .############        ############. 
  .#############      #############. 
  .#############      #############. 
  .############        ############. 
  .###########          ###########. 
  .##########     ##     ##########. 
  . ########     ####     ######## . 
  . #######     ######     ####### . 
  . #######    ########    ####### . 
  .  #######  ##########  #######  . 
  .  ############################  . 
  .   ##########################   . 
  .    ########################    . 
  .     ######################     . 
  .      ####################      . 
  .       ##################       . 
  .         ##############         . 
 __            ########            __

Char 67 (/home/kraus/git/open-iconic/png/task-4x.png), width 32
  .######################          . 
  .#####################      ##   . 
  .####################      ####  . 
  .###################      ###### . 
  .####                    ####### . 
  .####                   #######  . 
  .####                  #######   . 
  .####                 #######    . 
  .####                #######     . 
  .####       ##      #######      . 
  .####      ####    #######       . 
  .####     ######  #######        . 
  .####     ##############         . 
  .####      ############          . 
  .####       ##########      #    . 
  .####        ########      ##    . 
  .####         ######      ###    . 
  .####          ####      ####    . 
  .####           ##       ####    . 
  .####                    ####    . 
  .####                    ####    . 
  .####                    ####    . 
  .####                    ####    . 
  .####                    ####    . 
  .############################    . 
  .############################    . 
  .############################    . 
  .############################    . 
  .                                . 
  .                                . 
  .                                . 
 __                                __

Char 68 (/home/kraus/git/open-iconic/png/x-4x.png), width 32
  .     #                   #      . 
  .    ###                 ###     . 
  .   #####               #####    . 
  .  #######             #######   . 
  . #########           #########  . 
  .###########         ########### . 
  . ###########       ############ . 
  .  ###########     ############  . 
  .   ###########   ############   . 
  .    ########### ############    . 
  .     ######################     . 
  .      ####################      . 
  .       ##################       . 
  .        ################        . 
  .         ##############         . 
  .          ############          . 
  .         #############          . 
  .        ###############         . 
  .       #################        . 
  .      ###################       . 
  .     #####################      . 
  .    #######################     . 
  .   ############  ###########    . 
  .  ############    ###########   . 
  . ############      ###########  . 
  .############        ########### . 
  . ##########          ########## . 
  .  ########            ########  . 
  .   ######              ######   . 
  .    ####                ####    . 
  .     ##                  ##     . 
 __                                __
