Font: open_iconic_weather_4x (Symbols-bdf-sources/open_iconic_weather_4x.bdf)
Declared name: open_iconic_weather_4x
Declared family: iconic
Declared weight: none
Declared size: None
Characters: 6
Height: 32
Baseline: 32
Max width: 32
Fixed width: True

Char 64 (/home/kraus/git/open-iconic/png/cloud-4x.png), width 32
  .                                . 
  .                                . 
  .                                . 
  .                                . 
  .               ######           . 
  .             ##########         . 
  .           ##############       . 
  .          ################      . 
  .         #################      . 
  .         ##################     . 
  .        ###################     . 
  .        ####################    . 
  .     #######################    . 
  .   #########################    . 
  .  ##########################    . 
  . ###########################    . 
  . ############################   . 
  .##############################  . 
  .############################### . 
  .############################### . 
  .################################. 
  .################################. 
  .################################. 
  . ###############################. 
  . ############################## . 
  .  ############################# . 
  .   ###########################  . 
  .     #######################    . 
  .                                . 
  .                                . 
  .                                . 
  .                                . 

Char 65 (/home/kraus/git/open-iconic/png/cloudy-4x.png), width 32
  .       ######                   . 
  .     ##########                 . 
  .   ##############               . 
  .  ################              . 
  .  ############                  . 
  . ###########                    . 
  . #########                      . 
  .#########                       . 
  .########       ######           . 
  .#######      ##########         . 
  .######     ##############       . 
  .#####     ################      . 
  .#####    #################      . 
  . #       ##################     . 
  .        ###################     . 
  .        ####################    . 
  .     #######################    . 
  .   #########################    . 
  .  ##########################    . 
  . ###########################    . 
  . ############################   . 
  .##############################  . 
  .############################### . 
  .############################### . 
  .################################. 
  .################################. 
  .################################. 
  . ###############################. 
  . ############################## . 
  .  ############################# . 
  .   ###########################  . 
  .     #######################    . 

Char 66 (/home/kraus/git/open-iconic/png/moon-4x.png), width 32
  .          #                     . 
  .        ##                      . 
  .      ####                      . 
  .     #####                      . 
  .    ######                      . 
  .   #######                      . 
  .   #######                      . 
  .  ########                      . 
  . #########                      . 
  . ##########                     . 
  . ##########                     . 
  .###########                     . 
  .############                    . 
  .############                    . 
  .#############                   . 
  .##############                  . 
  .###############                 . 
  .################                . 
  .#################               . 
  . ##################             . 
  . #####################        # . 
  . ############################## . 
  .  ############################  . 
  .  ############################  . 
  .   ##########################   . 
  .    ########################    . 
  .     ######################     . 
  .      ####################      . 
  .       ##################       . 
  .         ##############         . 
  .            ########            . 
  .                                . 

Char 67 (/home/kraus/git/open-iconic/png/rain-4x.png), width 32
  .               ######           . 
  .             ##########         . 
  .           ##############       . 
  .          ################      . 
  .         #################      . 
  .         ##################     . 
  .        ###################     . 
  .        ####################    . 
  .     #######################    . 
  .   #########################    . 
  .  ##########################    . 
  . ###########################    . 
  . ############################   . 
  .##############################  . 
  .############################### . 
  .################################. 
  .############    ################. 
  .##########        ##############. 
  .#########          #############. 
  . ########          #############. 
  . ##          ##         ####### . 
  .            ####          ##### . 
  .            ####           ###  . 
  .            ####                . 
  .     ##     ####     ##         . 
  .    ####    ####    ####        . 
  .    ####    ####    ####        . 
  .    ####    ####    ####        . 
  .    ####    ####    ####        . 
  .    ####    ####    ####        . 
  .    ####    ####    ####        . 
  .     ##      ##      ##         . 

Char 68 (/home/kraus/git/open-iconic/png/star-4x.png), width 32
  .                                . 
  .                                . 
  .               ##               . 
  .               ##               . 
  .               ##               . 
  .              ####              . 
  .              ####              . 
  .              ####              . 
  .             ######             . 
  .             ######             . 
  .             ######             . 
  .            ########            . 
  . ############################## . 
  .  ############################  . 
  .   ##########################   . 
  .    ########################    . 
  .      ####################      . 
  .       ##################       . 
  .        ################        . 
  .         ##############         . 
  .          ############          . 
  .          ############          . 
  .         ##############         . 
  .         ##############         . 
  .         ######  ######         . 
  .        ######    ######        . 
  .        #####      #####        . 
  .        ####        ####        . 
  .       ###            ###       . 
  .       ##              ##       . 
  .       #                #       . 
  .                                . 

Char 69 (/home/kraus/git/open-iconic/png/sun-4x.png), width 32
  .               ##               . 
  .              ####              . 
  .              ####              . 
  .               ##               . 
  .     ##                  ##     . 
  .    ####                ####    . 
  .    ####                ####    . 
  .     ##                  ##     . 
  .             ######             . 
  .           ##########           . 
  .          ############          . 
  .         ##############         . 
  .         ##############         . 
  .        ################        . 
  . ##     ################     ## . 
  .####    ################    ####. 
  .####    ################    ####. 
  . ##     ################     ## . 
  .        ################        . 
  .         ##############         . 
  .         ##############         . 
  .          ############          . 
  .           ##########           . 
  .             ######             . 
  .     ##                  ##     . 
  .    ####                ####    . 
  .    ####                ####    . 
  .     ##                  ##     . 
  .               ##               . 
  .              ####              . 
  .              ####              . 
  .               ##               . 
