Font: open_iconic_email_4x (Symbols-bdf-sources/open_iconic_email_4x.bdf)
Declared name: open_iconic_email_4x
Declared family: iconic
Declared weight: none
Declared size: None
Characters: 5
Height: 32
Baseline: 32
Max width: 32
Fixed width: True

Char 64 (/home/kraus/git/open-iconic/png/envelope-closed-4x.png), width 32
  .                                . 
  .                                . 
  .                                . 
  .                                . 
  .################################. 
  .################################. 
  .################################. 
  .################################. 
  . ############################## . 
  .   ##########################   . 
  .     ######################     . 
  .       ##################       . 
  .#        ##############        #. 
  .###        ##########        ###. 
  .#####        ######        #####. 
  .#######        ##        #######. 
  .#########              #########. 
  .###########          ###########. 
  .#############      #############. 
  .###############  ###############. 
  .################################. 
  .################################. 
  .################################. 
  .################################. 
  .################################. 
  .################################. 
  .################################. 
  .################################. 
  .                                . 
  .                                . 
  .                                . 
  .                                . 

Char 65 (/home/kraus/git/open-iconic/png/envelope-open-4x.png), width 32
  .               ##               . 
  .             ######             . 
  .           ##########           . 
  .         ##############         . 
  .       ##################       . 
  .     #########    #########     . 
  .   #########        #########   . 
  . #########            ######### . 
  .########                ########. 
  .######                    ######. 
  .####                        ####. 
  .####                        ####. 
  .####    ################    ####. 
  .####    ################    ####. 
  .####    ################    ####. 
  .####    ################    ####. 
  .####     ##############     ####. 
  .####       ##########       ####. 
  .#####        ######        #####. 
  .#######        ##        #######. 
  .#########              #########. 
  .###########          ###########. 
  .#############      #############. 
  .###############  ###############. 
  .################################. 
  .################################. 
  .################################. 
  .################################. 
  .################################. 
  .################################. 
  .################################. 
  .################################. 

Char 66 (/home/kraus/git/open-iconic/png/inbox-4x.png), width 32
  .################################. 
  .################################. 
  .################################. 
  .################################. 
  .################################. 
  .################################. 
  .################################. 
  .################################. 
  .####                        ####. 
  .####                        ####. 
  .####                        ####. 
  .####                        ####. 
  .####                        ####. 
  .####                        ####. 
  .####                        ####. 
  .####                        ####. 
  .####                        ####. 
  .####                        ####. 
  .####                        ####. 
  .####                        ####. 
  .########                ########. 
  .#########              #########. 
  .##########            ##########. 
  .###########          ###########. 
  .################################. 
  .################################. 
  .################################. 
  .################################. 
  .################################. 
  .################################. 
  .################################. 
  .################################. 

Char 67 (/home/kraus/git/open-iconic/png/tag-4x.png), width 32
  .############                    . 
  .#############                   . 
  .##############                  . 
  .###############                 . 
  .######    ######                . 
  .#####      ######               . 
  .####        ######              . 
  .####        #######             . 
  .####        ########            . 
  .####        #########           . 
  .#####      ###########          . 
  .######    #############         . 
  . #######################        . 
  .  #######################       . 
  .   #######################      . 
  .    #######################     . 
  .     #######################    . 
  .      #######################   . 
  .       #######################  . 
  .        ####################### . 
  .         ###################### . 
  .          ####################  . 
  .           ##################   . 
  .            ################    . 
  .             ##############     . 
  .              ############      . 
  .               ##########       . 
  .                ########        . 
  .                 ######         . 
  .                  ####          . 
  .                   ##           . 
  .                                . 

Char 68 (/home/kraus/git/open-iconic/png/tags-4x.png), width 32
  .                                . 
  .                                . 
  .                                . 
  .                                . 
  .########      ######            . 
  .#########      ######           . 
  .##########      ######          . 
  .###########      ######         . 
  .#####  #####      ######        . 
  .####    #####      ######       . 
  .####    ######      ######      . 
  .#####  ########      ######     . 
  . ###############      ######    . 
  .  ###############      ######   . 
  .   ###############      ######  . 
  .    ###############      ###### . 
  .     ##############      ###### . 
  .      ############      ######  . 
  .       ##########      ######   . 
  .        ########      ######    . 
  .         ######      ######     . 
  .          ####        ####      . 
  .           ##          ##       . 
  .                                . 
  .                                . 
  .                                . 
  .                                . 
  .                                . 
  .                                . 
  .                                . 
  .                                . 
  .                                . 
