Font: open_iconic_email_6x (Symbols-bdf-sources/open_iconic_email_6x.bdf)
Declared name: open_iconic_email_6x
Declared family: iconic
Declared weight: none
Declared size: None
Characters: 5
Height: 48
Baseline: 48
Max width: 48
Fixed width: True

Char 64 (/home/kraus/git/open-iconic/png/envelope-closed-6x.png), width 48
  .                                                . 
  .                                                . 
  .                                                . 
  .                                                . 
  .                                                . 
  .                                                . 
  .################################################. 
  .################################################. 
  .################################################. 
  .################################################. 
  .################################################. 
  .################################################. 
  . ############################################## . 
  .   ##########################################   . 
  .     ######################################     . 
  .       ##################################       . 
  .         ##############################         . 
  .           ##########################           . 
  .#            ######################            #. 
  .###            ##################            ###. 
  .#####            ##############            #####. 
  .#######            ##########            #######. 
  .#########            ######            #########. 
  .###########            ##            ###########. 
  .#############                      #############. 
  .###############                  ###############. 
  .#################              #################. 
  .###################          ###################. 
  .#####################      #####################. 
  .#######################  #######################. 
  .################################################. 
  .################################################. 
  .################################################. 
  .################################################. 
  .################################################. 
  .################################################. 
  .################################################. 
  .################################################. 
  .################################################. 
  .################################################. 
  .################################################. 
  .################################################. 
  .                                                . 
  .                                                . 
  .                                                . 
  .                                                . 
  .                                                . 
 __                                                __

Char 65 (/home/kraus/git/open-iconic/png/envelope-open-6x.png), width 48
  .                       ##                       . 
  .                     ######                     . 
  .                   ##########                   . 
  .                 ##############                 . 
  .               ##################               . 
  .             ######################             . 
  .           ##########################           . 
  .         ##############  ##############         . 
  .       ##############      ##############       . 
  .     ##############          ##############     . 
  .   ##############              ##############   . 
  . ##############                  ############## . 
  .#############                      #############. 
  .###########                          ###########. 
  .#########                              #########. 
  .#######                                  #######. 
  .######                                    ######. 
  .######                                    ######. 
  .######      ########################      ######. 
  .######      ########################      ######. 
  .######      ########################      ######. 
  .######      ########################      ######. 
  .######      ########################      ######. 
  .######      ########################      ######. 
  .######       ######################       ######. 
  .######         ##################         ######. 
  .######           ##############           ######. 
  .#######            ##########            #######. 
  .#########            ######            #########. 
  .###########            ##            ###########. 
  .#############                      #############. 
  .###############                  ###############. 
  .#################              #################. 
  .###################          ###################. 
  .#####################      #####################. 
  .#######################  #######################. 
  .################################################. 
  .################################################. 
  .################################################. 
  .################################################. 
  .################################################. 
  .################################################. 
  .################################################. 
  .################################################. 
  .################################################. 
  .################################################. 
  .################################################. 
 __################################################__

Char 66 (/home/kraus/git/open-iconic/png/inbox-6x.png), width 48
  .################################################. 
  .################################################. 
  .################################################. 
  .################################################. 
  .################################################. 
  .################################################. 
  .################################################. 
  .################################################. 
  .################################################. 
  .################################################. 
  .################################################. 
  .################################################. 
  .######                                    ######. 
  .######                                    ######. 
  .######                                    ######. 
  .######                                    ######. 
  .######                                    ######. 
  .######                                    ######. 
  .######                                    ######. 
  .######                                    ######. 
  .######                                    ######. 
  .######                                    ######. 
  .######                                    ######. 
  .######                                    ######. 
  .######                                    ######. 
  .######                                    ######. 
  .######                                    ######. 
  .######                                    ######. 
  .######                                    ######. 
  .######                                    ######. 
  .############                        ############. 
  .#############                      #############. 
  .##############                    ##############. 
  .###############                  ###############. 
  .################                ################. 
  .#################              #################. 
  .################################################. 
  .################################################. 
  .################################################. 
  .################################################. 
  .################################################. 
  .################################################. 
  .################################################. 
  .################################################. 
  .################################################. 
  .################################################. 
  .################################################. 
 __################################################__

Char 67 (/home/kraus/git/open-iconic/png/tag-6x.png), width 48
  .##################                              . 
  .###################                             . 
  .####################                            . 
  .#####################                           . 
  .######################                          . 
  .#######################                         . 
  .##########    ##########                        . 
  .########        #########                       . 
  .#######          #########                      . 
  .#######          ##########                     . 
  .######            ##########                    . 
  .######            ###########                   . 
  .######            ############                  . 
  .######            #############                 . 
  .#######          ###############                . 
  .#######          ################               . 
  .########        ##################              . 
  .##########    #####################             . 
  . ###################################            . 
  .  ###################################           . 
  .   ###################################          . 
  .    ###################################         . 
  .     ###################################        . 
  .      ###################################       . 
  .       ###################################      . 
  .        ###################################     . 
  .         ###################################    . 
  .          ###################################   . 
  .           ###################################  . 
  .            ################################### . 
  .             ################################## . 
  .              ################################  . 
  .               ##############################   . 
  .                ############################    . 
  .                 ##########################     . 
  .                  ########################      . 
  .                   ######################       . 
  .                    ####################        . 
  .                     ##################         . 
  .                      ################          . 
  .                       ##############           . 
  .                        ############            . 
  .                         ##########             . 
  .                          ########              . 
  .                           ######               . 
  .                            ####                . 
  .                             ##                 . 
 __                                                __

Char 68 (/home/kraus/git/open-iconic/png/tags-6x.png), width 48
  .                                                . 
  .                                                . 
  .                                                . 
  .                                                . 
  .                                                . 
  .                                                . 
  .############         #########                  . 
  .#############         #########                 . 
  .##############         #########                . 
  .###############         #########               . 
  .################         #########              . 
  .#################         #########             . 
  .#######    #######         #########            . 
  .######      #######         #########           . 
  .######      ########         #########          . 
  .######      #########         #########         . 
  .######      ##########         #########        . 
  .#######    ############         #########       . 
  . #######################         #########      . 
  .  #######################         #########     . 
  .   #######################         #########    . 
  .    #######################         #########   . 
  .     #######################         #########  . 
  .      #######################         ######### . 
  .       ######################         ######### . 
  .        ####################         #########  . 
  .         ##################         #########   . 
  .          ################         #########    . 
  .           ##############         #########     . 
  .            ############         #########      . 
  .             ##########         #########       . 
  .              ########          ########        . 
  .               ######            ######         . 
  .                ####              ####          . 
  .                 ##                ##           . 
  .                                                . 
  .                                                . 
  .                                                . 
  .                                                . 
  .                                                . 
  .                                                . 
  .                                                . 
  .                                                . 
  .                                                . 
  .                                                . 
  .                                                . 
  .                                                . 
 __                                                __
