Font: 9x15B (Latin-1-bdf-sources/9x15B.bdf)
Declared name: -misc-fixed-bold-r-normal--15-140-75-75-c-90-iso10646-1
Declared family: fixed
Declared weight: bold
Declared size: 15
Characters: 15
Height: 11
Baseline: 10
Max width: 9
Fixed width: True

Char 32 (space), width 9
  .         . 
  .         . 
  .         . 
  .         . 
  .         . 
  .         . 
  .         . 
  .         . 
  .         . 
 __         __
  .         . 

Char 43 (plus), width 9
  .         . 
  .         . 
  .   ##    . 
  .   ##    . 
  .   ##    . 
  .######## . 
  .   ##    . 
  .   ##    . 
  .   ##    . 
 __         __
  .         . 

Char 45 (hyphen), width 9
  .         . 
  .         . 
  .         . 
  .         . 
  .         . 
  .######## . 
  .         . 
  .         . 
  .         . 
 __         __
  .         . 

Char 46 (period), width 9
  .         . 
  .         . 
  .         . 
  .         . 
  .         . 
  .         . 
  .         . 
  .         . 
  .   ##    . 
 __  ####   __
  .   ##    . 

Char 48 (zero), width 9
  .   ##    . 
  .  ####   . 
  . ##  ##  . 
  .##    ## . 
  .##    ## . 
  .##    ## . 
  .##    ## . 
  . ##  ##  . 
  .  ####   . 
 __   ##    __
  .         . 

Char 49 (one), width 9
  .   ##    . 
  .  ###    . 
  . ####    . 
  .   ##    . 
  .   ##    . 
  .   ##    . 
  .   ##    . 
  .   ##    . 
  .   ##    . 
 __ ######  __
  .         . 

Char 50 (two), width 9
  .  ####   . 
  . ##  ##  . 
  .##    ## . 
  .      ## . 
  .     ##  . 
  .    ##   . 
  .   ##    . 
  .  ##     . 
  . ##      . 
 __######## __
  .         . 

Char 51 (three), width 9
  . #####   . 
  .##   ##  . 
  .      ## . 
  .     ##  . 
  .   ###   . 
  .     ##  . 
  .      ## . 
  .      ## . 
  .##   ##  . 
 __ #####   __
  .         . 

Char 52 (four), width 9
  .     ##  . 
  .    ###  . 
  .   ####  . 
  .  ## ##  . 
  . ##  ##  . 
  .##   ##  . 
  .######## . 
  .     ##  . 
  .     ##  . 
 __     ##  __
  .         . 

Char 53 (five), width 9
  .#######  . 
  .##       . 
  .##       . 
  .## ###   . 
  .###  ##  . 
  .      ## . 
  .      ## . 
  .##    ## . 
  . ##  ##  . 
 __  ####   __
  .         . 

Char 54 (six), width 9
  .  ####   . 
  . ##  ##  . 
  .##    #  . 
  .##       . 
  .## ###   . 
  .###  ##  . 
  .##    ## . 
  .##    ## . 
  . ##  ##  . 
 __  ####   __
  .         . 

Char 55 (seven), width 9
  .######## . 
  .      ## . 
  .      ## . 
  .     ##  . 
  .    ##   . 
  .    ##   . 
  .   ##    . 
  .   ##    . 
  .   ##    . 
 __   ##    __
  .         . 

Char 56 (eight), width 9
  .  ####   . 
  . ##  ##  . 
  .##    ## . 
  . ##  ##  . 
  .  ####   . 
  . ##  ##  . 
  .##    ## . 
  .##    ## . 
  . ##  ##  . 
 __  ####   __
  .         . 

Char 57 (nine), width 9
  .  ####   . 
  . ##  ##  . 
  .##    ## . 
  .##    ## . 
  . ##  ### . 
  .  ### ## . 
  .      ## . 
  . #    ## . 
  . ##  ##  . 
 __  ####   __
  .         . 

Char 58 (colon), width 9
  .         . 
  .         . 
  .         . 
  .   ##    . 
  .  ####   . 
  .   ##    . 
  .         . 
  .         . 
  .   ##    . 
 __  ####   __
  .   ##    . 
