Font: 9x18 (Latin-1-bdf-sources/9x18.bdf)
Declared name: -misc-fixed-medium-r-normal--18-120-100-100-c-90-iso10646-1
Declared family: fixed
Declared weight: medium
Declared size: 18
Characters: 15
Height: 10
Baseline: 10
Max width: 9
Fixed width: True

Char 32 (space), width 9
  .         . 
  .         . 
  .         . 
  .         . 
  .         . 
  .         . 
  .         . 
  .         . 
  .         . 
  .         . 

Char 43 (plus), width 9
  .         . 
  .         . 
  .    #    . 
  .    #    . 
  .    #    . 
  . ####### . 
  .    #    . 
  .    #    . 
  .    #    . 
  .         . 

Char 45 (hyphen), width 9
  .         . 
  .         . 
  .         . 
  .         . 
  .         . 
  . ####### . 
  .         . 
  .         . 
  .         . 
  .         . 

Char 46 (period), width 9
  .         . 
  .         . 
  .         . 
  .         . 
  .         . 
  .         . 
  .         . 
  .         . 
  .    ##   . 
  .    ##   . 

Char 48 (zero), width 9
  .   ###   . 
  .  #   #  . 
  . #     # . 
  . #     # . 
  . #     # . 
  . #     # . 
  . #     # . 
  . #     # . 
  .  #   #  . 
  .   ###   . 

Char 49 (one), width 9
  .    #    . 
  .   ##    . 
  .  # #    . 
  . #  #    . 
  .    #    . 
  .    #    . 
  .    #    . 
  .    #    . 
  .    #    . 
  . ####### . 

Char 50 (two), width 9
  .   ###   . 
  .  #   #  . 
  . #     # . 
  .       # . 
  .      #  . 
  .     #   . 
  .    #    . 
  .   #     . 
  .  #      . 
  . ####### . 

Char 51 (three), width 9
  . ####### . 
  .       # . 
  .      #  . 
  .     #   . 
  .    ##   . 
  .      #  . 
  .       # . 
  .       # . 
  . #    #  . 
  .  ####   . 

Char 52 (four), width 9
  .      #  . 
  .     ##  . 
  .    # #  . 
  .   #  #  . 
  .  #   #  . 
  . #    #  . 
  . ####### . 
  .      #  . 
  .      #  . 
  .      #  . 

Char 53 (five), width 9
  . ####### . 
  . #       . 
  . #       . 
  . #       . 
  . #####   . 
  .      #  . 
  .       # . 
  .       # . 
  . #    #  . 
  .  ####   . 

Char 54 (six), width 9
  .   ####  . 
  .  #      . 
  . #       . 
  . #       . 
  . # ###   . 
  . ##   #  . 
  . #     # . 
  . #     # . 
  .  #   #  . 
  .   ###   . 

Char 55 (seven), width 9
  . ####### . 
  .       # . 
  .      #  . 
  .      #  . 
  .     #   . 
  .     #   . 
  .    #    . 
  .    #    . 
  .    #    . 
  .    #    . 

Char 56 (eight), width 9
  .   ###   . 
  .  #   #  . 
  . #     # . 
  .  #   #  . 
  .   ###   . 
  .  #   #  . 
  . #     # . 
  . #     # . 
  .  #   #  . 
  .   ###   . 

Char 57 (nine), width 9
  .   ###   . 
  .  #   #  . 
  . #     # . 
  . #     # . 
  .  #   ## . 
  .   ### # . 
  .       # . 
  .       # . 
  .      #  . 
  .  ####   . 

Char 58 (colon), width 9
  .         . 
  .         . 
  .         . 
  .    ##   . 
  .    ##   . 
  .         . 
  .         . 
  .         . 
  .    ##   . 
  .    ##   . 
