Font: _8x13 (Latin-1-bdf-sources/8x13.bdf)
Declared name: -Misc-Fixed-Medium-R-Normal--13-120-75-75-C-80-ISO10646-1
Declared family: fixed
Declared weight: medium
Declared size: 13
Matching characters: 15
Height: 10
Baseline: 9
Max width: 8
Fixed width: True

Char: 32 (space), width: 8
  .        .
  .        .
  .        .
  .        .
  .        .
  .        .
  .        .
  .        .
  _        _
  .        .

Char: 43 (plus), width: 8
  .        .
  .        .
  .   #    .
  .   #    .
  . #####  .
  .   #    .
  .   #    .
  .        .
  _        _
  .        .

Char: 45 (hyphen), width: 8
  .        .
  .        .
  .        .
  .        .
  . #####  .
  .        .
  .        .
  .        .
  _        _
  .        .

Char: 46 (period), width: 8
  .        .
  .        .
  .        .
  .        .
  .        .
  .        .
  .        .
  .   #    .
  _  ###   _
  .   #    .

Char: 48 (zero), width: 8
  .   ##   .
  .  #  #  .
  . #    # .
  . #    # .
  . #    # .
  . #    # .
  . #    # .
  .  #  #  .
  _   ##   _
  .        .

Char: 49 (one), width: 8
  .   #    .
  .  ##    .
  . # #    .
  .   #    .
  .   #    .
  .   #    .
  .   #    .
  .   #    .
  _ #####  _
  .        .

Char: 50 (two), width: 8
  .  ####  .
  . #    # .
  . #    # .
  .      # .
  .     #  .
  .   ##   .
  .  #     .
  . #      .
  _ ###### _
  .        .

Char: 51 (three), width: 8
  . ###### .
  .      # .
  .     #  .
  .    #   .
  .   ###  .
  .      # .
  .      # .
  . #    # .
  _  ####  _
  .        .

Char: 52 (four), width: 8
  .     #  .
  .    ##  .
  .   # #  .
  .  #  #  .
  . #   #  .
  . #   #  .
  . ###### .
  .     #  .
  _     #  _
  .        .

Char: 53 (five), width: 8
  . ###### .
  . #      .
  . #      .
  . # ###  .
  . ##   # .
  .      # .
  .      # .
  . #    # .
  _  ####  _
  .        .

Char: 54 (six), width: 8
  .   ###  .
  .  #     .
  . #      .
  . #      .
  . # ###  .
  . ##   # .
  . #    # .
  . #    # .
  _  ####  _
  .        .

Char: 55 (seven), width: 8
  . ###### .
  .      # .
  .     #  .
  .    #   .
  .    #   .
  .   #    .
  .   #    .
  .  #     .
  _  #     _
  .        .

Char: 56 (eight), width: 8
  .  ####  .
  . #    # .
  . #    # .
  . #    # .
  .  ####  .
  . #    # .
  . #    # .
  . #    # .
  _  ####  _
  .        .

Char: 57 (nine), width: 8
  .  ####  .
  . #    # .
  . #    # .
  . #   ## .
  .  ### # .
  .      # .
  .      # .
  .     #  .
  _  ###   _
  .        .

Char: 58 (colon), width: 8
  .        .
  .        .
  .   #    .
  .  ###   .
  .   #    .
  .        .
  .        .
  .   #    .
  _  ###   _
  .   #    .
