Font: _9x15 (Latin-1-bdf-sources/9x15.bdf)
Declared name: -Misc-Fixed-Medium-R-Normal--15-140-75-75-C-90-ISO10646-1
Declared family: fixed
Declared weight: medium
Declared size: 15
Matching characters: 15
Height: 10
Baseline: 10
Max width: 9
Fixed width: True

Char: 32 (space), width: 9
  .         .
  .         .
  .         .
  .         .
  .         .
  .         .
  .         .
  .         .
  .         .
  _         _

Char: 43 (plus), width: 9
  .         .
  .         .
  .    #    .
  .    #    .
  .    #    .
  . ####### .
  .    #    .
  .    #    .
  .    #    .
  _         _

Char: 45 (hyphen), width: 9
  .         .
  .         .
  .         .
  .         .
  .         .
  . ####### .
  .         .
  .         .
  .         .
  _         _

Char: 46 (period), width: 9
  .         .
  .         .
  .         .
  .         .
  .         .
  .         .
  .         .
  .         .
  .    ##   .
  _    ##   _

Char: 48 (zero), width: 9
  .   ###   .
  .  #   #  .
  . #     # .
  . #     # .
  . #     # .
  . #     # .
  . #     # .
  . #     # .
  .  #   #  .
  _   ###   _

Char: 49 (one), width: 9
  .    #    .
  .   ##    .
  .  # #    .
  . #  #    .
  .    #    .
  .    #    .
  .    #    .
  .    #    .
  .    #    .
  _ ####### _

Char: 50 (two), width: 9
  .  #####  .
  . #     # .
  . #     # .
  .      #  .
  .     #   .
  .    #    .
  .   #     .
  .  #      .
  . #       .
  _ ####### _

Char: 51 (three), width: 9
  . ####### .
  .       # .
  .      #  .
  .     #   .
  .    ###  .
  .       # .
  .       # .
  .       # .
  . #     # .
  _  #####  _

Char: 52 (four), width: 9
  .      #  .
  .     ##  .
  .    # #  .
  .   #  #  .
  .  #   #  .
  . #    #  .
  . ####### .
  .      #  .
  .      #  .
  _      #  _

Char: 53 (five), width: 9
  . ####### .
  . #       .
  . #       .
  . # ####  .
  . ##    # .
  .       # .
  .       # .
  .       # .
  . #     # .
  _  #####  _

Char: 54 (six), width: 9
  .   ####  .
  .  #      .
  . #       .
  . #       .
  . # ####  .
  . ##    # .
  . #     # .
  . #     # .
  . #     # .
  _  #####  _

Char: 55 (seven), width: 9
  . ####### .
  .       # .
  .      #  .
  .      #  .
  .     #   .
  .     #   .
  .    #    .
  .    #    .
  .   #     .
  _   #     _

Char: 56 (eight), width: 9
  .   ###   .
  .  #   #  .
  . #     # .
  .  #   #  .
  .   ###   .
  .  #   #  .
  . #     # .
  . #     # .
  .  #   #  .
  _   ###   _

Char: 57 (nine), width: 9
  .  #####  .
  . #     # .
  . #     # .
  . #     # .
  . #    ## .
  .  #### # .
  .       # .
  .       # .
  .      #  .
  _  ####   _

Char: 58 (colon), width: 9
  .         .
  .         .
  .         .
  .    ##   .
  .    ##   .
  .         .
  .         .
  .         .
  .    ##   .
  _    ##   _
