Font: 6x10 (Latin-1-bdf-sources/6x10.bdf)
Declared name: -misc-fixed-medium-r-normal--10-100-75-75-c-60-iso10646-1
Declared family: fixed
Declared weight: medium
Declared size: 10
Characters: 15
Height: 8
Baseline: 7
Max width: 6
Fixed width: True

Char 32 (space), width 6
 __      __
  .      . 
  .      . 
  .      . 
  .      . 
  .      . 
  .      . 
  .      . 

Char 43 (plus), width 6
 __      __
  .  #   . 
  .  #   . 
  .##### . 
  .  #   . 
  .  #   . 
  .      . 
  .      . 

Char 45 (hyphen), width 6
 __      __
  .      . 
  .      . 
  .##### . 
  .      . 
  .      . 
  .      . 
  .      . 

Char 46 (period), width 6
 __      __
  .      . 
  .      . 
  .      . 
  .      . 
  .  #   . 
  . ###  . 
  .  #   . 

Char 48 (zero), width 6
 __  #   __
  . # #  . 
  .#   # . 
  .#   # . 
  .#   # . 
  . # #  . 
  .  #   . 
  .      . 

Char 49 (one), width 6
 __  #   __
  . ##   . 
  .# #   . 
  .  #   . 
  .  #   . 
  .  #   . 
  .##### . 
  .      . 

Char 50 (two), width 6
 __ ###  __
  .#   # . 
  .    # . 
  .  ##  . 
  . #    . 
  .#     . 
  .##### . 
  .      . 

Char 51 (three), width 6
 __##### __
  .    # . 
  .   #  . 
  .  ##  . 
  .    # . 
  .#   # . 
  . ###  . 
  .      . 

Char 52 (four), width 6
 __   #  __
  .  ##  . 
  . # #  . 
  .#  #  . 
  .##### . 
  .   #  . 
  .   #  . 
  .      . 

Char 53 (five), width 6
 __##### __
  .#     . 
  .# ##  . 
  .##  # . 
  .    # . 
  .#   # . 
  . ###  . 
  .      . 

Char 54 (six), width 6
 __  ##  __
  . #    . 
  .#     . 
  .# ##  . 
  .##  # . 
  .#   # . 
  . ###  . 
  .      . 

Char 55 (seven), width 6
 __##### __
  .    # . 
  .   #  . 
  .   #  . 
  .  #   . 
  . #    . 
  . #    . 
  .      . 

Char 56 (eight), width 6
 __ ###  __
  .#   # . 
  .#   # . 
  . ###  . 
  .#   # . 
  .#   # . 
  . ###  . 
  .      . 

Char 57 (nine), width 6
 __ ###  __
  .#   # . 
  .#  ## . 
  . ## # . 
  .    # . 
  .   #  . 
  . ##   . 
  .      . 

Char 58 (colon), width 6
 __      __
  .  #   . 
  . ###  . 
  .  #   . 
  .      . 
  .  #   . 
  . ###  . 
  .  #   . 
