Font: 6x9 (Latin-1-bdf-sources/6x9.bdf)
Declared name: -misc-fixed-medium-r-normal--9-90-75-75-c-60-iso10646-1
Declared family: fixed
Declared weight: medium
Declared size: 9
Characters: 15
Height: 6
Baseline: 6
Max width: 6
Fixed width: True

Char 32 (space), width 6
  .      . 
  .      . 
  .      . 
  .      . 
  .      . 
  .      . 

Char 43 (plus), width 6
  .      . 
  .  #   . 
  .  #   . 
  .##### . 
  .  #   . 
  .  #   . 

Char 45 (hyphen), width 6
  .      . 
  .      . 
  .      . 
  .##### . 
  .      . 
  .      . 

Char 46 (period), width 6
  .      . 
  .      . 
  .      . 
  .      . 
  .  ##  . 
  .  ##  . 

Char 48 (zero), width 6
  .  ##  . 
  . #  # . 
  . #  # . 
  . #  # . 
  . #  # . 
  .  ##  . 

Char 49 (one), width 6
  .  #   . 
  . ##   . 
  .  #   . 
  .  #   . 
  .  #   . 
  . ###  . 

Char 50 (two), width 6
  .  ##  . 
  . #  # . 
  .    # . 
  .   #  . 
  .  #   . 
  . #### . 

Char 51 (three), width 6
  . #### . 
  .   #  . 
  .  ##  . 
  .    # . 
  .    # . 
  . ###  . 

Char 52 (four), width 6
  .   #  . 
  .  ##  . 
  . # #  . 
  .#  #  . 
  .##### . 
  .   #  . 

Char 53 (five), width 6
  . #### . 
  . #    . 
  . ###  . 
  .    # . 
  .    # . 
  . ###  . 

Char 54 (six), width 6
  .  ##  . 
  . #    . 
  . ###  . 
  . #  # . 
  . #  # . 
  .  ##  . 

Char 55 (seven), width 6
  . #### . 
  .    # . 
  .    # . 
  .   #  . 
  .  #   . 
  .  #   . 

Char 56 (eight), width 6
  .  ##  . 
  . #  # . 
  .  ##  . 
  . #  # . 
  . #  # . 
  .  ##  . 

Char 57 (nine), width 6
  .  ##  . 
  . #  # . 
  . #  # . 
  .  ### . 
  .    # . 
  .  ##  . 

Char 58 (colon), width 6
  .      . 
  .  ##  . 
  .  ##  . 
  .      . 
  .  ##  . 
  .  ##  . 
