Font: 7x13O (Latin-1-bdf-sources/7x13O.bdf)
Declared name: -misc-fixed-medium-o-normal--13-120-75-75-c-70-iso10646-1
Declared family: fixed
Declared weight: medium
Declared size: 13
Characters: 15
Height: 10
Baseline: 9
Max width: 7
Fixed width: True

Char 32 (space), width 7
  .       . 
  .       . 
  .       . 
  .       . 
  .       . 
  .       . 
  .       . 
  .       . 
 __       __
  .       . 

Char 43 (plus), width 7
  .       . 
  .       . 
  .   #   . 
  .   #   . 
  . ####  . 
  .  #    . 
  .  #    . 
  .       . 
 __       __
  .       . 

Char 45 (hyphen), width 7
  .       . 
  .       . 
  .       . 
  .       . 
  . ##### . 
  .       . 
  .       . 
  .       . 
 __       __
  .       . 

Char 46 (period), width 7
  .       . 
  .       . 
  .       . 
  .       . 
  .       . 
  .       . 
  .       . 
  .   #   . 
 __  ###  __
  .   #   . 

Char 48 (zero), width 7
  .   ##  . 
  .  #  # . 
  . #    #. 
  . #    #. 
  . #    #. 
  .#    # . 
  .#    # . 
  . #  #  . 
 __  ##   __
  .       . 

Char 49 (one), width 7
  .    #  . 
  .   ##  . 
  .  # #  . 
  .    #  . 
  .    #  . 
  .   #   . 
  .   #   . 
  .   #   . 
 __ ##### __
  .       . 

Char 50 (two), width 7
  .  #### . 
  . #    #. 
  . #    #. 
  .      #. 
  .    ## . 
  .  ##   . 
  . #     . 
  .#      . 
 __###### __
  .       . 

Char 51 (three), width 7
  . ######. 
  .      #. 
  .     # . 
  .    #  . 
  .   ##  . 
  .     # . 
  .     # . 
  .#    # . 
 __ ####  __
  .       . 

Char 52 (four), width 7
  .     # . 
  .    ## . 
  .   # # . 
  .  #  # . 
  . #  #  . 
  .#   #  . 
  .###### . 
  .    #  . 
 __    #  __
  .       . 

Char 53 (five), width 7
  .  #####. 
  .  #    . 
  .  #    . 
  . # ### . 
  . ##   #. 
  .      #. 
  .     # . 
  .#    # . 
 __ ####  __
  .       . 

Char 54 (six), width 7
  .   ### . 
  .  #    . 
  . #     . 
  . #     . 
  . ####  . 
  .#    # . 
  .#    # . 
  .#    # . 
 __ ####  __
  .       . 

Char 55 (seven), width 7
  .###### . 
  .     # . 
  .    #  . 
  .   #   . 
  .  #    . 
  . #     . 
  . #     . 
  .#      . 
 __#      __
  .       . 

Char 56 (eight), width 7
  .  #### . 
  . #    #. 
  . #    #. 
  . #    #. 
  . ##### . 
  .#    # . 
  .#    # . 
  .#    # . 
 __ ####  __
  .       . 

Char 57 (nine), width 7
  . ####  . 
  .#    # . 
  .#    # . 
  .#   ## . 
  . ### # . 
  .    #  . 
  .    #  . 
  .   #   . 
 __###    __
  .       . 

Char 58 (colon), width 7
  .       . 
  .       . 
  .   #   . 
  .  ###  . 
  .   #   . 
  .       . 
  .       . 
  .  #    . 
 __ ###   __
  .  #    . 
