Font: _7x14B (Latin-1-bdf-sources/7x14B.bdf)
Declared name: -Misc-Fixed-Bold-R-Normal--14-130-75-75-C-70-ISO10646-1
Declared family: fixed
Declared weight: bold
Declared size: 14
Matching characters: 15
Height: 10
Baseline: 10
Max width: 7
Fixed width: True

Char: 32 (space), width: 7
  .       .
  .       .
  .       .
  .       .
  .       .
  .       .
  .       .
  .       .
  .       .
  _       _

Char: 43 (plus), width: 7
  .       .
  .       .
  .  ##   .
  .  ##   .
  .  ##   .
  .###### .
  .  ##   .
  .  ##   .
  .  ##   .
  _       _

Char: 45 (hyphen), width: 7
  .       .
  .       .
  .       .
  .       .
  .       .
  .###### .
  .       .
  .       .
  .       .
  _       _

Char: 46 (period), width: 7
  .       .
  .       .
  .       .
  .       .
  .       .
  .       .
  .       .
  .       .
  .  ##   .
  _  ##   _

Char: 48 (zero), width: 7
  . ####  .
  .##  ## .
  .##  ## .
  .##  ## .
  .##  ## .
  .##  ## .
  .##  ## .
  .##  ## .
  .##  ## .
  _ ####  _

Char: 49 (one), width: 7
  .  ##   .
  . ###   .
  .####   .
  .  ##   .
  .  ##   .
  .  ##   .
  .  ##   .
  .  ##   .
  .  ##   .
  _###### _

Char: 50 (two), width: 7
  . ####  .
  .##  ## .
  .##  ## .
  .    ## .
  .   ##  .
  .   ##  .
  .  ##   .
  . ##    .
  .##     .
  _###### _

Char: 51 (three), width: 7
  . ####  .
  .##  ## .
  .##  ## .
  .    ## .
  .  ###  .
  .    ## .
  .    ## .
  .##  ## .
  .##  ## .
  _ ####  _

Char: 52 (four), width: 7
  .    #  .
  .   ##  .
  .   ##  .
  .  ###  .
  . ####  .
  .## ##  .
  .## ##  .
  .###### .
  .   ##  .
  _   ##  _

Char: 53 (five), width: 7
  .###### .
  .##     .
  .##     .
  .#####  .
  .##  ## .
  .    ## .
  .    ## .
  .##  ## .
  .##  ## .
  _ ####  _

Char: 54 (six), width: 7
  .  ###  .
  . ## ## .
  .##  ## .
  .##     .
  .#####  .
  .##  ## .
  .##  ## .
  .##  ## .
  .##  ## .
  _ ####  _

Char: 55 (seven), width: 7
  .###### .
  .##  ## .
  .## ##  .
  .   ##  .
  .  ##   .
  .  ##   .
  .  ##   .
  .  ##   .
  .  ##   .
  _  ##   _

Char: 56 (eight), width: 7
  . ####  .
  .##  ## .
  .##  ## .
  .##  ## .
  . ####  .
  . ####  .
  .##  ## .
  .##  ## .
  .##  ## .
  _ ####  _

Char: 57 (nine), width: 7
  . ####  .
  .##  ## .
  .##  ## .
  .##  ## .
  .##  ## .
  . ##### .
  .    ## .
  .##  ## .
  .## ##  .
  _ ###   _

Char: 58 (colon), width: 7
  .       .
  .       .
  .  ##   .
  .  ##   .
  .       .
  .       .
  .       .
  .  ##   .
  .  ##   .
  _       _
