Font: open_iconic_all_1x (Symbols-bdf-sources/open_iconic_all_1x.bdf)
Declared name: open_iconic_all_1x
Declared family: iconic
Declared weight: none
Declared size: None
Characters: 31
Height: 8
Baseline: 8
Max width: 8
Fixed width: True

Char 256 (/home/kraus/git/open-iconic/png/sort-descending.png), width 8
  .  # ####. 
  .  #     . 
  .  # ### . 
  .  #     . 
  .  # ##  . 
  .  #     . 
  . ###    . 
 __  #     __

Char 257 (/home/kraus/git/open-iconic/png/spreadsheet.png), width 8
  .########. 
  .# #    #. 
  .########. 
  .# #    #. 
  .########. 
  .# #    #. 
  .########. 
 __        __

Char 258 (/home/kraus/git/open-iconic/png/star.png), width 8
  .        . 
  .        . 
  .   ##   . 
  . ###### . 
  .  ####  . 
  .  ####  . 
  .  #  #  . 
 __        __

Char 259 (/home/kraus/git/open-iconic/png/sun.png), width 8
  .        . 
  . #    # . 
  .   ##   . 
  .  ####  . 
  .  ####  . 
  .   ##   . 
  . #    # . 
 __        __

Char 260 (/home/kraus/git/open-iconic/png/tablet.png), width 8
  .####### . 
  .#     # . 
  .#     # . 
  .#     # . 
  .#     # . 
  .#     # . 
  .####### . 
 __####### __

Char 261 (/home/kraus/git/open-iconic/png/tag.png), width 8
  .###     . 
  .#  #    . 
  .#  ##   . 
  . #####  . 
  .  ##### . 
  .   #### . 
  .    ##  . 
 __        __

Char 262 (/home/kraus/git/open-iconic/png/tags.png), width 8
  .        . 
  .##  #   . 
  .# #  #  . 
  . ###  # . 
  .  ##  # . 
  .        . 
  .        . 
 __        __

Char 263 (/home/kraus/git/open-iconic/png/target.png), width 8
  .  ####  . 
  . #    # . 
  .#  ##  #. 
  .# #  # #. 
  .# #  # #. 
  .#  ##  #. 
  . #    # . 
 __  ####  __

Char 264 (/home/kraus/git/open-iconic/png/task.png), width 8
  .#####   . 
  .#     # . 
  .#    #  . 
  .#  ##   . 
  .#     # . 
  .#     # . 
  .####### . 
 __        __

Char 265 (/home/kraus/git/open-iconic/png/terminal.png), width 8
  .########. 
  .# ######. 
  .## #####. 
  .# ##   #. 
  .########. 
  .########. 
  .########. 
 __########__

Char 266 (/home/kraus/git/open-iconic/png/text.png), width 8
  .########. 
  .#  ##  #. 
  .   ##   . 
  .   ##   . 
  .   ##   . 
  .   ##   . 
  .   ##   . 
 __  ####  __

Char 267 (/home/kraus/git/open-iconic/png/thumb-down.png), width 8
  .# ####  . 
  .# ####  . 
  .# ##### . 
  .# ##### . 
  .   ##   . 
  .   ##   . 
  .    #   . 
 __        __

Char 268 (/home/kraus/git/open-iconic/png/thumb-up.png), width 8
  .    #   . 
  .   ##   . 
  .   ##   . 
  .# ##### . 
  .# ##### . 
  .# ####  . 
  .# ####  . 
 __        __

Char 269 (/home/kraus/git/open-iconic/png/timer.png), width 8
  .  ###   . 
  .  ###   . 
  . #      . 
  .#   # # . 
  .#  #  # . 
  .#     # . 
  . #   #  . 
 __  ###   __

Char 270 (/home/kraus/git/open-iconic/png/transfer.png), width 8
  .      # . 
  .########. 
  .      # . 
  .        . 
  . #      . 
  .########. 
  . #      . 
 __        __

Char 271 (/home/kraus/git/open-iconic/png/trash.png), width 8
  .  ###   . 
  .####### . 
  .        . 
  . # # #  . 
  . # # #  . 
  . # # #  . 
  . # # #  . 
 __ #####  __

Char 272 (/home/kraus/git/open-iconic/png/underline.png), width 8
  . ##  #  . 
  . ##  #  . 
  . ##  #  . 
  . ##  #  . 
  . ##  #  . 
  .  ###   . 
  .        . 
 __####### __

Char 273 (/home/kraus/git/open-iconic/png/vertical-align-bottom.png), width 8
  .##    ##. 
  .##    ##. 
  .## ## ##. 
  .## ## ##. 
  .## ## ##. 
  .        . 
  .########. 
 __        __

Char 274 (/home/kraus/git/open-iconic/png/vertical-align-center.png), width 8
  .##    ##. 
  .## ## ##. 
  .        . 
  .########. 
  .        . 
  .## ## ##. 
  .##    ##. 
 __        __

Char 275 (/home/kraus/git/open-iconic/png/vertical-align-top.png), width 8
  .########. 
  .        . 
  .## ## ##. 
  .## ## ##. 
  .## ## ##. 
  .##    ##. 
  .##    ##. 
 __        __

Char 276 (/home/kraus/git/open-iconic/png/video.png), width 8
  .        . 
  .######  . 
  .###### #. 
  .########. 
  .###### #. 
  .######  . 
  .        . 
 __        __

Char 277 (/home/kraus/git/open-iconic/png/volume-high.png), width 8
  .   #    . 
  .  ## ## . 
  .####  ##. 
  .#### # #. 
  .#### # #. 
  .####  ##. 
  .  ## ## . 
 __   #    __

Char 278 (/home/kraus/git/open-iconic/png/volume-low.png), width 8
  .    #   . 
  .   ##   . 
  . ####   . 
  . #### # . 
  . #### # . 
  . ####   . 
  .   ##   . 
 __    #   __

Char 279 (/home/kraus/git/open-iconic/png/volume-off.png), width 8
  .     #  . 
  .    ##  . 
  .  ####  . 
  .  ####  . 
  .  ####  . 
  .  ####  . 
  .    ##  . 
 __     #  __

Char 280 (/home/kraus/git/open-iconic/png/warning.png), width 8
  .   #    . 
  .  ###   . 
  .  ###   . 
  . ## #   . 
  . ## ##  . 
  . #####  . 
  .### ### . 
 __####### __

Char 281 (/home/kraus/git/open-iconic/png/wifi.png), width 8
  . #####  . 
  .#     # . 
  .        . 
  .  ###   . 
  .        . 
  .        . 
  .   ##   . 
 __   ##   __

Char 282 (/home/kraus/git/open-iconic/png/wrench.png), width 8
  .    #   . 
  .   ##   . 
  .   ##   . 
  .   #####. 
  .  ##### . 
  . ###    . 
  .###     . 
 __##      __

Char 283 (/home/kraus/git/open-iconic/png/x.png), width 8
  . #    # . 
  .###  ###. 
  . ###### . 
  .  ####  . 
  .  ####  . 
  . ###### . 
  .###  ###. 
 __ #    # __

Char 284 (/home/kraus/git/open-iconic/png/yen.png), width 8
  .#     # . 
  . #   #  . 
  .  # #   . 
  .####### . 
  .   #    . 
  .####### . 
  .   #    . 
 __   #    __

Char 285 (/home/kraus/git/open-iconic/png/zoom-in.png), width 8
  .  ###   . 
  . #   #  . 
  .#  #  # . 
  .# ### # . 
  .#  #  # . 
  . #   ## . 
  .  ######. 
 __      ##__

Char 286 (/home/kraus/git/open-iconic/png/zoom-out.png), width 8
  .  ###   . 
  . #   #  . 
  .#     # . 
  .# ### # . 
  .#     # . 
  . #   ## . 
  .  ######. 
 __      ##__
