Font: cursorr (Symbols-bdf-sources/cursorr.bdf)
Declared name: cursor
Declared family: generic
Declared weight: none
Declared size: None
Characters: 12
Height: 23
Baseline: 7
Max width: 17
Fixed width: True

Char 2 (arrow), width 17
  .                 . 
  .                 . 
  .                 . 
  .                 . 
  .                 . 
  .                 . 
 __                 __
  .            ##   . 
  .          ####   . 
  .        #####    . 
  .      #######    . 
  .    ########     . 
  .  ##########     . 
  .      #####      . 
  .     ######      . 
  .    ### ##       . 
  .   ###  ##       . 
  .  ###   #        . 
  . ###    #        . 
  .###              . 
  . #               . 
  .                 . 
  .                 . 

Char 3 (arrow_mask), width 17
  .                 . 
  .                 . 
  .                 . 
  .                 . 
  .                 . 
  .                 . 
 __             ### __
  .           ##### . 
  .         ####### . 
  .       ########  . 
  .     ##########  . 
  .   ###########   . 
  .  ############   . 
  .  ###########    . 
  .     ########    . 
  .    ########     . 
  .   #########     . 
  .  ##### ###      . 
  . #####  ###      . 
  .#####    #       . 
  . ###             . 
  .  #              . 
  .                 . 

Char 22 (center_ptr), width 17
  .                 . 
  .                 . 
  .                 . 
  .                 . 
  .                 . 
  .                 . 
 __                 __
  .    ##           . 
  .    ##           . 
  .   ####          . 
  .   ####          . 
  .  ######         . 
  .  ######         . 
  . ########        . 
  . ########        . 
  .##  ##  ##       . 
  .#   ##   #       . 
  .    ##           . 
  .    ##           . 
  .    ##           . 
  .    ##           . 
  .                 . 
  .                 . 

Char 23 (center_ptr_mask), width 17
  .                 . 
  .                 . 
  .                 . 
  .                 . 
  .                 . 
  .                 . 
 __    ####         __
  .    ####         . 
  .   ######        . 
  .   ######        . 
  .  ########       . 
  .  ########       . 
  . ##########      . 
  . ##########      . 
  .############     . 
  .############     . 
  .############     . 
  .### #### ###     . 
  .    ####         . 
  .    ####         . 
  .    ####         . 
  .    ####         . 
  .                 . 

Char 30 (cross), width 17
  .      # #        . 
  .      # #        . 
  .      # #        . 
  .      # #        . 
  .      # #        . 
  .      # #        . 
 __####### ######## __
  .                 . 
  .####### ######## . 
  .      # #        . 
  .      # #        . 
  .      # #        . 
  .      # #        . 
  .      # #        . 
  .      # #        . 
  .                 . 
  .                 . 
  .                 . 
  .                 . 
  .                 . 
  .                 . 
  .                 . 
  .                 . 

Char 31 (cross_mask), width 17
  .     #####       . 
  .     #####       . 
  .     #####       . 
  .     #####       . 
  .     #####       . 
  .################ . 
 __################ __
  .################ . 
  .################ . 
  .################ . 
  .     #####       . 
  .     #####       . 
  .     #####       . 
  .     #####       . 
  .     #####       . 
  .     #####       . 
  .                 . 
  .                 . 
  .                 . 
  .                 . 
  .                 . 
  .                 . 
  .                 . 

Char 34 (crosshair), width 17
  .       #         . 
  .       #         . 
  .       #         . 
  .       #         . 
  .       #         . 
  .       #         . 
 __       #         __
  .####### ######## . 
  .       #         . 
  .       #         . 
  .       #         . 
  .       #         . 
  .       #         . 
  .       #         . 
  .       #         . 
  .                 . 
  .                 . 
  .                 . 
  .                 . 
  .                 . 
  .                 . 
  .                 . 
  .                 . 

Char 35 (crosshair_mask), width 17
  .      ###        . 
  .      ###        . 
  .      ###        . 
  .      ###        . 
  .      ###        . 
  .      ###        . 
 __################ __
  .################ . 
  .################ . 
  .      ###        . 
  .      ###        . 
  .      ###        . 
  .      ###        . 
  .      ###        . 
  .      ###        . 
  .      ###        . 
  .                 . 
  .                 . 
  .                 . 
  .                 . 
  .                 . 
  .                 . 
  .                 . 

Char 44 (draft_large), width 17
  .                 . 
  .                 . 
  .                 . 
  .                 . 
  .                 . 
  .                 . 
 __                 __
  .              #  . 
  .            ##   . 
  .          ####   . 
  .        #####    . 
  .      #######    . 
  .    ########     . 
  .  ##########     . 
  .       ####      . 
  .      # ###      . 
  .     #  ##       . 
  .    #   ##       . 
  .   #    #        . 
  .  #     #        . 
  . #               . 
  .#                . 
  .                 . 

Char 45 (draft_large_mask), width 17
  .                 . 
  .                 . 
  .                 . 
  .                 . 
  .                 . 
  .                 . 
 __                 __
  .             ##  . 
  .           ####  . 
  .         ######  . 
  .       #######   . 
  .     ########    . 
  .   ##########    . 
  . ###########     . 
  . ###########     . 
  .     ######      . 
  .    #######      . 
  .   ### ###       . 
  .  ###  ###       . 
  . ###   ##        . 
  .###    ##        . 
  .##               . 
  .#                . 

Char 46 (draft_small), width 17
  .                 . 
  .                 . 
  .                 . 
  .                 . 
  .                 . 
  .                 . 
 __                 __
  .              #  . 
  .            ##   . 
  .          ####   . 
  .        #####    . 
  .      #######    . 
  .         ###     . 
  .        # ##     . 
  .       #  #      . 
  .      #   #      . 
  .     #           . 
  .    #            . 
  .   #             . 
  .  #              . 
  . #               . 
  .#                . 
  .                 . 

Char 47 (draft_small_mask), width 17
  .                 . 
  .                 . 
  .                 . 
  .                 . 
  .                 . 
  .                 . 
 __                 __
  .             ##  . 
  .           ####  . 
  .         #####   . 
  .       #######   . 
  .     ########    . 
  .     ########    . 
  .       #####     . 
  .      ######     . 
  .     ### ##      . 
  .    ###  #       . 
  .   ###           . 
  .  ###            . 
  . ###             . 
  .###              . 
  .##               . 
  .                 . 

Font rendering notes:
Char 2:
  Negative horizontal padding (-13), zeroing.
Char 3:
  Negative horizontal padding (-14), zeroing.
Char 22:
  Negative horizontal padding (-4), zeroing.
Char 23:
  Negative horizontal padding (-5), zeroing.
Char 30:
  Negative horizontal padding (-7), zeroing.
Char 31:
  Negative horizontal padding (-7), zeroing.
Char 34:
  Negative horizontal padding (-7), zeroing.
Char 35:
  Negative horizontal padding (-7), zeroing.
Char 44:
  Negative horizontal padding (-14), zeroing.
Char 45:
  Negative horizontal padding (-14), zeroing.
Char 46:
  Negative horizontal padding (-14), zeroing.
Char 47:
  Negative horizontal padding (-14), zeroing.
