Font: battery19 (Symbols-bdf-sources/battery19.bdf)
Declared name: battery19
Declared family: generic
Declared weight: none
Declared size: None
Characters: 7
Height: 19
Baseline: 19
Max width: 9
Fixed width: True

Char 48 (048), width 9
  .  ####   . 
  .######## . 
  .#      # . 
  .#      # . 
  .#      # . 
  .#      # . 
  .#      # . 
  .#      # . 
  .#      # . 
  .#      # . 
  .#      # . 
  .#      # . 
  .#      # . 
  .#      # . 
  .#      # . 
  .#      # . 
  .#      # . 
  .#      # . 
 __######## __

Char 49 (049), width 9
  .  ####   . 
  .######## . 
  .#      # . 
  .#      # . 
  .#      # . 
  .#      # . 
  .#      # . 
  .#      # . 
  .#      # . 
  .#      # . 
  .#      # . 
  .#      # . 
  .#      # . 
  .#      # . 
  .#      # . 
  .# #### # . 
  .# #### # . 
  .#      # . 
 __######## __

Char 50 (050), width 9
  .  ####   . 
  .######## . 
  .#      # . 
  .#      # . 
  .#      # . 
  .#      # . 
  .#      # . 
  .#      # . 
  .#      # . 
  .#      # . 
  .#      # . 
  .#      # . 
  .# #### # . 
  .# #### # . 
  .#      # . 
  .# #### # . 
  .# #### # . 
  .#      # . 
 __######## __

Char 51 (051), width 9
  .  ####   . 
  .######## . 
  .#      # . 
  .#      # . 
  .#      # . 
  .#      # . 
  .#      # . 
  .#      # . 
  .#      # . 
  .# #### # . 
  .# #### # . 
  .#      # . 
  .# #### # . 
  .# #### # . 
  .#      # . 
  .# #### # . 
  .# #### # . 
  .#      # . 
 __######## __

Char 52 (052), width 9
  .  ####   . 
  .######## . 
  .#      # . 
  .#      # . 
  .#      # . 
  .#      # . 
  .# #### # . 
  .# #### # . 
  .#      # . 
  .# #### # . 
  .# #### # . 
  .#      # . 
  .# #### # . 
  .# #### # . 
  .#      # . 
  .# #### # . 
  .# #### # . 
  .#      # . 
 __######## __

Char 53 (053), width 9
  .  ####   . 
  .######## . 
  .#      # . 
  .# #### # . 
  .# #### # . 
  .#      # . 
  .# #### # . 
  .# #### # . 
  .#      # . 
  .# #### # . 
  .# #### # . 
  .#      # . 
  .# #### # . 
  .# #### # . 
  .#      # . 
  .# #### # . 
  .# #### # . 
  .#      # . 
 __######## __

Char 54 (054), width 9
  .  ####   . 
  .######## . 
  .#      # . 
  .#      # . 
  .#      # . 
  .#   #  # . 
  .#   #  # . 
  .#  ##  # . 
  .#  ##  # . 
  .# #### # . 
  .# #### # . 
  .#  ##  # . 
  .#  ##  # . 
  .#  #   # . 
  .#  #   # . 
  .#      # . 
  .#      # . 
  .#      # . 
 __######## __
