Font: courR12 (Latin-1-bdf-sources/courR12.bdf)
Declared name: -Adobe-Courier-Medium-R-Normal--17-120-100-100-M-100-ISO10646-1
Declared family: courier
Declared weight: medium
Declared size: 17
Matching characters: 22
Height: 13
Baseline: 11
Max width: 10
Fixed width: True

Char: 32 (space), width: 10
  .          .
  .          .
  .          .
  .          .
  .          .
  .          .
  .          .
  .          .
  .          .
  .          .
  _          _
  .          .
  .          .

Char: 37 (percent), width: 10
  .  ###     .
  . #   #    .
  . #   #    .
  .  ###     .
  .      ##  .
  .   ###    .
  . ##       .
  .    ###   .
  .   #   #  .
  .   #   #  .
  _    ###   _
  .          .
  .          .

Char: 40 (parenleft), width: 10
  .     #    .
  .    #     .
  .    #     .
  .    #     .
  .   #      .
  .   #      .
  .   #      .
  .   #      .
  .   #      .
  .    #     .
  _    #     _
  .    #     .
  .     #    .

Char: 41 (parenright), width: 10
  .   #      .
  .    #     .
  .    #     .
  .    #     .
  .     #    .
  .     #    .
  .     #    .
  .     #    .
  .     #    .
  .    #     .
  _    #     _
  .    #     .
  .   #      .

Char: 42 (asterisk), width: 10
  .    #     .
  .    #     .
  . #######  .
  .   ###    .
  .   # #    .
  .  #   #   .
  .          .
  .          .
  .          .
  .          .
  _          _
  .          .
  .          .

Char: 43 (plus), width: 10
  .          .
  .          .
  .    #     .
  .    #     .
  .    #     .
  .    #     .
  . #######  .
  .    #     .
  .    #     .
  .    #     .
  _    #     _
  .          .
  .          .

Char: 44 (comma), width: 10
  .          .
  .          .
  .          .
  .          .
  .          .
  .          .
  .          .
  .          .
  .          .
  .    ##    .
  _    ##    _
  .    #     .
  .   #      .

Char: 45 (hyphen), width: 10
  .          .
  .          .
  .          .
  .          .
  .          .
  .          .
  . #######  .
  .          .
  .          .
  .          .
  _          _
  .          .
  .          .

Char: 46 (period), width: 10
  .          .
  .          .
  .          .
  .          .
  .          .
  .          .
  .          .
  .          .
  .          .
  .    ##    .
  _    ##    _
  .          .
  .          .

Char: 47 (slash), width: 10
  .       #  .
  .       #  .
  .      #   .
  .      #   .
  .     #    .
  .     #    .
  .     #    .
  .    #     .
  .    #     .
  .   #      .
  _   #      _
  .  #       .
  .  #       .

Char: 48 (zero), width: 10
  .   ###    .
  .  #   #   .
  .  #   #   .
  . #     #  .
  . #     #  .
  . #     #  .
  . #     #  .
  . #     #  .
  .  #   #   .
  .  #   #   .
  _   ###    _
  .          .
  .          .

Char: 49 (one), width: 10
  .    #     .
  .   ##     .
  . ## #     .
  .    #     .
  .    #     .
  .    #     .
  .    #     .
  .    #     .
  .    #     .
  .    #     .
  _ #######  _
  .          .
  .          .

Char: 50 (two), width: 10
  .   ###    .
  .  #   #   .
  . #     #  .
  .       #  .
  .       #  .
  .      #   .
  .     #    .
  .    #     .
  .   #      .
  .  #    #  .
  _ #######  _
  .          .
  .          .

Char: 51 (three), width: 10
  .   ###    .
  .  #   #   .
  . #     #  .
  .      #   .
  .    ##    .
  .      #   .
  .       #  .
  .       #  .
  . #     #  .
  .  #   #   .
  _   ###    _
  .          .
  .          .

Char: 52 (four), width: 10
  .     ##   .
  .     ##   .
  .    # #   .
  .   #  #   .
  .   #  #   .
  .  #   #   .
  . #    #   .
  . #######  .
  .      #   .
  .      #   .
  _    ####  _
  .          .
  .          .

Char: 53 (five), width: 10
  .  ######  .
  .  #       .
  .  #       .
  .  #       .
  .  ####    .
  .  #   #   .
  .       #  .
  .       #  .
  . #     #  .
  .  #   #   .
  _   ###    _
  .          .
  .          .

Char: 54 (six), width: 10
  .    ###   .
  .  ##      .
  .  #       .
  . #        .
  . # ###    .
  . ##   #   .
  . #     #  .
  . #     #  .
  . #     #  .
  .  #   #   .
  _   ###    _
  .          .
  .          .

Char: 55 (seven), width: 10
  .  ######  .
  .  #    #  .
  .       #  .
  .      #   .
  .      #   .
  .      #   .
  .     #    .
  .     #    .
  .     #    .
  .    #     .
  _    #     _
  .          .
  .          .

Char: 56 (eight), width: 10
  .    ##    .
  .   #  #   .
  .  #    #  .
  .  #    #  .
  .   ####   .
  .   #  #   .
  .  #    #  .
  .  #    #  .
  .  #    #  .
  .   #  #   .
  _    ##    _
  .          .
  .          .

Char: 57 (nine), width: 10
  .   ###    .
  .  #   #   .
  . #     #  .
  . #     #  .
  .  #   ##  .
  .   ### #  .
  .       #  .
  .       #  .
  .      #   .
  .     ##   .
  _  ###     _
  .          .
  .          .

Char: 58 (colon), width: 10
  .          .
  .          .
  .          .
  .          .
  .    ##    .
  .    ##    .
  .          .
  .          .
  .          .
  .    ##    .
  _    ##    _
  .          .
  .          .

Char: 176 (degree), width: 10
  .   ###    .
  .  #   #   .
  .  #   #   .
  .  #   #   .
  .   ###    .
  .          .
  .          .
  .          .
  .          .
  .          .
  _          _
  .          .
  .          .
