Font: courB12 (Latin-1-bdf-sources/courB12.bdf)
Declared name: -adobe-courier-bold-r-normal--17-120-100-100-m-100-iso10646-1
Declared family: courier
Declared weight: bold
Declared size: 17
Characters: 22
Height: 15
Baseline: 12
Max width: 10
Fixed width: True

Char 32 (space), width 10
  .          . 
  .          . 
  .          . 
  .          . 
  .          . 
  .          . 
  .          . 
  .          . 
  .          . 
  .          . 
  .          . 
 __          __
  .          . 
  .          . 
  .          . 

Char 37 (percent), width 10
  .          . 
  .  ####    . 
  . ##  ##   . 
  . ##  ##   . 
  .  ####    . 
  .      ### . 
  .   ####   . 
  . ###      . 
  .    ####  . 
  .   ##  ## . 
  .   ##  ## . 
 __    ####  __
  .          . 
  .          . 
  .          . 

Char 40 (parenleft), width 10
  .          . 
  .     ##   . 
  .    ##    . 
  .    ##    . 
  .    ##    . 
  .   ##     . 
  .   ##     . 
  .   ##     . 
  .   ##     . 
  .   ##     . 
  .    ##    . 
 __    ##    __
  .    ##    . 
  .     ##   . 
  .          . 

Char 41 (parenright), width 10
  .          . 
  .  ##      . 
  .   ##     . 
  .   ##     . 
  .   ##     . 
  .    ##    . 
  .    ##    . 
  .    ##    . 
  .    ##    . 
  .    ##    . 
  .   ##     . 
 __   ##     __
  .   ##     . 
  .  ##      . 
  .          . 

Char 42 (asterisk), width 10
  .          . 
  .    ##    . 
  .    ##    . 
  . ######## . 
  .   ####   . 
  .   ####   . 
  .  ##  ##  . 
  .          . 
  .          . 
  .          . 
  .          . 
 __          __
  .          . 
  .          . 
  .          . 

Char 43 (plus), width 10
  .          . 
  .          . 
  .          . 
  .    ##    . 
  .    ##    . 
  .    ##    . 
  . ######## . 
  . ######## . 
  .    ##    . 
  .    ##    . 
  .    ##    . 
 __          __
  .          . 
  .          . 
  .          . 

Char 44 (comma), width 10
  .          . 
  .          . 
  .          . 
  .          . 
  .          . 
  .          . 
  .          . 
  .          . 
  .          . 
  .          . 
  .   ###    . 
 __   ###    __
  .    ##    . 
  .   ##     . 
  .   #      . 

Char 45 (hyphen), width 10
  .          . 
  .          . 
  .          . 
  .          . 
  .          . 
  .          . 
  . #######  . 
  . #######  . 
  .          . 
  .          . 
  .          . 
 __          __
  .          . 
  .          . 
  .          . 

Char 46 (period), width 10
  .          . 
  .          . 
  .          . 
  .          . 
  .          . 
  .          . 
  .          . 
  .          . 
  .          . 
  .          . 
  .   ###    . 
 __   ###    __
  .          . 
  .          . 
  .          . 

Char 47 (slash), width 10
  .      ##  . 
  .      ##  . 
  .     ##   . 
  .     ##   . 
  .     ##   . 
  .    ##    . 
  .    ##    . 
  .   ##     . 
  .   ##     . 
  .   ##     . 
  .  ##      . 
 __  ##      __
  . ##       . 
  . ##       . 
  .          . 

Char 48 (zero), width 10
  .          . 
  .   ####   . 
  .  ##  ##  . 
  .  ##  ##  . 
  . ##    ## . 
  . ##    ## . 
  . ##    ## . 
  . ##    ## . 
  . ##    ## . 
  .  ##  ##  . 
  .  ##  ##  . 
 __   ####   __
  .          . 
  .          . 
  .          . 

Char 49 (one), width 10
  .          . 
  .    ##    . 
  .  ####    . 
  . ## ##    . 
  .    ##    . 
  .    ##    . 
  .    ##    . 
  .    ##    . 
  .    ##    . 
  .    ##    . 
  .    ##    . 
 __ ######## __
  .          . 
  .          . 
  .          . 

Char 50 (two), width 10
  .          . 
  .  ####    . 
  . ##  ##   . 
  . #    ##  . 
  .      ##  . 
  .      ##  . 
  .     ##   . 
  .    ##    . 
  .   ##     . 
  .  ##      . 
  . ##   ##  . 
 __ #######  __
  .          . 
  .          . 
  .          . 

Char 51 (three), width 10
  .          . 
  .  ####    . 
  . ##  ##   . 
  . #    ##  . 
  .     ##   . 
  .   ###    . 
  .     ##   . 
  .      ##  . 
  .      ##  . 
  . #    ##  . 
  . ##  ##   . 
 __  ####    __
  .          . 
  .          . 
  .          . 

Char 52 (four), width 10
  .          . 
  .      ##  . 
  .     ###  . 
  .    ####  . 
  .   ## ##  . 
  .  ##  ##  . 
  .  #   ##  . 
  . ##   ##  . 
  . ######## . 
  .      ##  . 
  .      ##  . 
 __    ##### __
  .          . 
  .          . 
  .          . 

Char 53 (five), width 10
  .          . 
  . #######  . 
  . ##       . 
  . ##       . 
  . ##       . 
  . ######   . 
  . ##   ##  . 
  .      ##  . 
  .      ##  . 
  .      ##  . 
  . ##  ##   . 
 __ #####    __
  .          . 
  .          . 
  .          . 

Char 54 (six), width 10
  .          . 
  .    ####  . 
  .  ###     . 
  .  ##      . 
  . ##       . 
  . ## ###   . 
  . ###  ##  . 
  . ##    ## . 
  . ##    ## . 
  . ##    ## . 
  .  ##  ##  . 
 __   ####   __
  .          . 
  .          . 
  .          . 

Char 55 (seven), width 10
  .          . 
  . #######  . 
  . ##   ##  . 
  .      ##  . 
  .     ##   . 
  .     ##   . 
  .    ##    . 
  .    ##    . 
  .    ##    . 
  .   ##     . 
  .   ##     . 
 __   ##     __
  .          . 
  .          . 
  .          . 

Char 56 (eight), width 10
  .          . 
  .   ###    . 
  .  ## ##   . 
  . ##   ##  . 
  .  #   #   . 
  .   ###    . 
  .  ## ##   . 
  . ##   ##  . 
  . ##   ##  . 
  . ##   ##  . 
  .  ## ##   . 
 __   ###    __
  .          . 
  .          . 
  .          . 

Char 57 (nine), width 10
  .          . 
  .   ####   . 
  .  ##  ##  . 
  . ##    ## . 
  . ##    ## . 
  .  ##  ### . 
  .   ### ## . 
  .       ## . 
  .       ## . 
  .      ##  . 
  .     ###  . 
 __  ####    __
  .          . 
  .          . 
  .          . 

Char 58 (colon), width 10
  .          . 
  .          . 
  .          . 
  .          . 
  .          . 
  .   ###    . 
  .   ###    . 
  .          . 
  .          . 
  .          . 
  .   ###    . 
 __   ###    __
  .          . 
  .          . 
  .          . 

Char 176 (degree), width 10
  .          . 
  .   ###    . 
  .  ## ##   . 
  .  #   #   . 
  .  ## ##   . 
  .   ###    . 
  .          . 
  .          . 
  .          . 
  .          . 
  .          . 
 __          __
  .          . 
  .          . 
  .          . 
