Font: courB08 (Latin-1-bdf-sources/courB08.bdf)
Declared name: -adobe-courier-bold-r-normal--11-80-100-100-m-60-iso10646-1
Declared family: courier
Declared weight: bold
Declared size: 11
Characters: 22
Height: 9
Baseline: 7
Max width: 6
Fixed width: True

Char 32 (space), width 6
  .      . 
 __      __
  .      . 
  .      . 
  .      . 
  .      . 
  .      . 
  .      . 
  .      . 

Char 37 (percent), width 6
  .###   . 
 __# # # __
  .####  . 
  .  #   . 
  . #### . 
  .# # # . 
  .  ### . 
  .      . 
  .      . 

Char 40 (parenleft), width 6
  .   #  . 
 __  #   __
  . ##   . 
  . ##   . 
  . ##   . 
  . ##   . 
  .  #   . 
  .   #  . 
  .      . 

Char 41 (parenright), width 6
  . #    . 
 __  #   __
  .  ##  . 
  .  ##  . 
  .  ##  . 
  .  ##  . 
  .  #   . 
  . #    . 
  .      . 

Char 42 (asterisk), width 6
  .  #   . 
 __####  __
  . ##   . 
  .#  #  . 
  .      . 
  .      . 
  .      . 
  .      . 
  .      . 

Char 43 (plus), width 6
  .      . 
 __  #   __
  .  #   . 
  .##### . 
  .  #   . 
  .  #   . 
  .      . 
  .      . 
  .      . 

Char 44 (comma), width 6
  .      . 
 __      __
  .      . 
  .      . 
  .      . 
  .      . 
  .  ##  . 
  .  #   . 
  . #    . 

Char 45 (hyphen), width 6
  .      . 
 __      __
  .      . 
  .##### . 
  .      . 
  .      . 
  .      . 
  .      . 
  .      . 

Char 46 (period), width 6
  .      . 
 __      __
  .      . 
  .      . 
  .      . 
  .      . 
  . ##   . 
  .      . 
  .      . 

Char 47 (slash), width 6
  .    # . 
 __    # __
  .   #  . 
  .   #  . 
  .  #   . 
  .  #   . 
  . #    . 
  . #    . 
  .      . 

Char 48 (zero), width 6
  . ###  . 
 __## ## __
  .## ## . 
  .## ## . 
  .## ## . 
  .## ## . 
  . ###  . 
  .      . 
  .      . 

Char 49 (one), width 6
  .  ##  . 
 __####  __
  .  ##  . 
  .  ##  . 
  .  ##  . 
  .  ##  . 
  .######. 
  .      . 
  .      . 

Char 50 (two), width 6
  . ###  . 
 __## ## __
  .   ## . 
  .  ##  . 
  . ##   . 
  .## ## . 
  .##### . 
  .      . 
  .      . 

Char 51 (three), width 6
  . ###  . 
 __## ## __
  .   ## . 
  . ###  . 
  .   ## . 
  .## ## . 
  . ###  . 
  .      . 
  .      . 

Char 52 (four), width 6
  .   ## . 
 __  ### __
  . # ## . 
  .## ## . 
  .######. 
  .   ## . 
  .   ## . 
  .      . 
  .      . 

Char 53 (five), width 6
  .##### . 
 __##    __
  .####  . 
  .## ## . 
  .   ## . 
  .#  ## . 
  .####  . 
  .      . 
  .      . 

Char 54 (six), width 6
  . ###  . 
 __## ## __
  .##    . 
  .####  . 
  .## ## . 
  .## ## . 
  . ###  . 
  .      . 
  .      . 

Char 55 (seven), width 6
  .##### . 
 __## ## __
  .   ## . 
  .  ##  . 
  .  ##  . 
  . ##   . 
  . ##   . 
  .      . 
  .      . 

Char 56 (eight), width 6
  . ###  . 
 __## ## __
  .## ## . 
  . ###  . 
  .## ## . 
  .## ## . 
  . ###  . 
  .      . 
  .      . 

Char 57 (nine), width 6
  . ###  . 
 __## ## __
  .## ## . 
  . #### . 
  .   ## . 
  .## ## . 
  . ###  . 
  .      . 
  .      . 

Char 58 (colon), width 6
  .      . 
 __      __
  .      . 
  . ##   . 
  .      . 
  .      . 
  . ##   . 
  .      . 
  .      . 

Char 176 (degree), width 6
  . ##   . 
 __#  #  __
  . ##   . 
  .      . 
  .      . 
  .      . 
  .      . 
  .      . 
  .      . 
