Font: courB10 (Latin-1-bdf-sources/courB10.bdf)
Declared name: -adobe-courier-bold-r-normal--14-100-100-100-m-90-iso10646-1
Declared family: courier
Declared weight: bold
Declared size: 14
Characters: 22
Height: 12
Baseline: 10
Max width: 9
Fixed width: True

Char 32 (space), width 9
  .         . 
  .         . 
  .         . 
  .         . 
  .         . 
  .         . 
  .         . 
  .         . 
  .         . 
 __         __
  .         . 
  .         . 

Char 37 (percent), width 9
  .  ##     . 
  . #  #    . 
  . #  #  # . 
  .  ## ##  . 
  .    #    . 
  .  ##     . 
  . #  ##   . 
  .   #  #  . 
  .   #  #  . 
 __    ##   __
  .         . 
  .         . 

Char 40 (parenleft), width 9
  .         . 
  .    ##   . 
  .   ##    . 
  .   ##    . 
  .  ##     . 
  .  ##     . 
  .  ##     . 
  .  ##     . 
  .  ##     . 
 __   ##    __
  .   ##    . 
  .    ##   . 

Char 41 (parenright), width 9
  .         . 
  .  ##     . 
  .   ##    . 
  .   ##    . 
  .    ##   . 
  .    ##   . 
  .    ##   . 
  .    ##   . 
  .    ##   . 
 __   ##    __
  .   ##    . 
  .  ##     . 

Char 42 (asterisk), width 9
  .         . 
  .    #    . 
  .  # # #  . 
  .  #####  . 
  .   ###   . 
  .  ## ##  . 
  .         . 
  .         . 
  .         . 
 __         __
  .         . 
  .         . 

Char 43 (plus), width 9
  .         . 
  .         . 
  .    #    . 
  .    #    . 
  .    #    . 
  . ####### . 
  .    #    . 
  .    #    . 
  .    #    . 
 __         __
  .         . 
  .         . 

Char 44 (comma), width 9
  .         . 
  .         . 
  .         . 
  .         . 
  .         . 
  .         . 
  .         . 
  .         . 
  .   ##    . 
 __   ##    __
  .  ##     . 
  .  #      . 

Char 45 (hyphen), width 9
  .         . 
  .         . 
  .         . 
  .         . 
  .         . 
  . ######  . 
  .         . 
  .         . 
  .         . 
 __         __
  .         . 
  .         . 

Char 46 (period), width 9
  .         . 
  .         . 
  .         . 
  .         . 
  .         . 
  .         . 
  .         . 
  .         . 
  .   ##    . 
 __   ##    __
  .         . 
  .         . 

Char 47 (slash), width 9
  .     ##  . 
  .     ##  . 
  .    ##   . 
  .    ##   . 
  .   ##    . 
  .   ##    . 
  .  ##     . 
  .  ##     . 
  . ##      . 
 __ ##      __
  .##       . 
  .##       . 

Char 48 (zero), width 9
  .   ###   . 
  .  ## ##  . 
  . ##   ## . 
  . ##   ## . 
  . ##   ## . 
  . ##   ## . 
  . ##   ## . 
  . ##   ## . 
  .  ## ##  . 
 __   ###   __
  .         . 
  .         . 

Char 49 (one), width 9
  .    ##   . 
  .  ####   . 
  .    ##   . 
  .    ##   . 
  .    ##   . 
  .    ##   . 
  .    ##   . 
  .    ##   . 
  .    ##   . 
 __  ###### __
  .         . 
  .         . 

Char 50 (two), width 9
  .  ####   . 
  . ##  ##  . 
  . ##  ##  . 
  .     ##  . 
  .     ##  . 
  .    ##   . 
  .   ##    . 
  .  ##     . 
  . ##      . 
 __ ######  __
  .         . 
  .         . 

Char 51 (three), width 9
  .  ####   . 
  . ##  ##  . 
  .     ##  . 
  .     ##  . 
  .   ###   . 
  .     ##  . 
  .     ##  . 
  .     ##  . 
  . ##  ##  . 
 __  ####   __
  .         . 
  .         . 

Char 52 (four), width 9
  .     ##  . 
  .    ###  . 
  .   ####  . 
  .   # ##  . 
  .  #  ##  . 
  . ##  ##  . 
  . #   ##  . 
  . ####### . 
  .     ##  . 
 __    #### __
  .         . 
  .         . 

Char 53 (five), width 9
  . ######  . 
  . ##      . 
  . ##      . 
  . #####   . 
  . ##  ##  . 
  .     ##  . 
  .     ##  . 
  .     ##  . 
  . ##  ##  . 
 __  ####   __
  .         . 
  .         . 

Char 54 (six), width 9
  .   ####  . 
  .  ##     . 
  . ##      . 
  . ## ##   . 
  . ### ##  . 
  . ##  ##  . 
  . ##  ##  . 
  . ##  ##  . 
  . ##  ##  . 
 __  ####   __
  .         . 
  .         . 

Char 55 (seven), width 9
  . ######  . 
  . #   ##  . 
  .     ##  . 
  .    ##   . 
  .    ##   . 
  .    ##   . 
  .    ##   . 
  .   ##    . 
  .   ##    . 
 __   ##    __
  .         . 
  .         . 

Char 56 (eight), width 9
  .  ####   . 
  . ##  ##  . 
  . ##  ##  . 
  . ##  ##  . 
  .  ####   . 
  . ##  ##  . 
  . ##  ##  . 
  . ##  ##  . 
  . ##  ##  . 
 __  ####   __
  .         . 
  .         . 

Char 57 (nine), width 9
  .  ####   . 
  . ##  ##  . 
  . ##  ##  . 
  . ##  ##  . 
  . ##  ##  . 
  . ##  ##  . 
  .  #####  . 
  .     ##  . 
  .    ##   . 
 __ ####    __
  .         . 
  .         . 

Char 58 (colon), width 9
  .         . 
  .         . 
  .         . 
  .   ##    . 
  .   ##    . 
  .         . 
  .         . 
  .         . 
  .   ##    . 
 __   ##    __
  .         . 
  .         . 

Char 176 (degree), width 9
  .         . 
  .   ##    . 
  .  #  #   . 
  .  #  #   . 
  .   ##    . 
  .         . 
  .         . 
  .         . 
  .         . 
 __         __
  .         . 
  .         . 
