Font: u8g2_percent_circle_25 (Symbols-bdf-sources/u8g2_percent_circle_25.bdf)
Declared name: unknown
Declared family: generic
Declared weight: none
Declared size: None
Characters: 9
Height: 25
Baseline: 25
Max width: 25
Fixed width: True

Char 48 (r000.png), width 25
  .            #            . 
  .         #######         . 
  .       ##   #   ##       . 
  .     ##           ##     . 
  .    #               #    . 
  .   #                 #   . 
  .   #                 #   . 
  .  #                   #  . 
  .  #        ###        #  . 
  . #         # #         # . 
  . #         # #         # . 
  . #         # #         # . 
  . #         # #         # . 
  . #         ###         # . 
  . #                     # . 
  . #                     # . 
  .  #       #   #       #  . 
  .  #          #        #  . 
  .   #        #        #   . 
  .   #       #         #   . 
  .    #     #   #     #    . 
  .     ##           ##     . 
  .       ##       ##       . 
  .         #######         . 
 __                         __

Char 49 (r125.png), width 25
  .            ######       . 
  .         ##########      . 
  .       ##   #########    . 
  .     ##         ######   . 
  .    #             ###    . 
  .   #               # #   . 
  .   #                 #   . 
  .  #                   #  . 
  .  #    # ###   ###    #  . 
  . #     #   #   #       # . 
  . #     # ###   ###     # . 
  . #     # #       #     # . 
  . #     # #       #     # . 
  . #     # ### # ###     # . 
  . #           #         # . 
  . #                     # . 
  .  #       #   #       #  . 
  .  #          #        #  . 
  .   #        #        #   . 
  .   #       #         #   . 
  .    #     #   #     #    . 
  .     ##           ##     . 
  .       ##       ##       . 
  .         #######         . 
 __                         __

Char 50 (r250.png), width 25
  .            ######       . 
  .         ##########      . 
  .       ##   #########    . 
  .     ##         ######   . 
  .    #             #####  . 
  .   #               ####  . 
  .   #                #### . 
  .  #                  ####. 
  .  #      ### ###     ####. 
  . #         # #        ###. 
  . #       ### ###      ###. 
  . #       #     #      ###. 
  . #       #     #      ###. 
  . #       ### ###       # . 
  . #                     # . 
  . #                     # . 
  .  #       #   #       #  . 
  .  #          #        #  . 
  .   #        #        #   . 
  .   #       #         #   . 
  .    #     #   #     #    . 
  .     ##           ##     . 
  .       ##       ##       . 
  .         #######         . 
 __                         __

Char 51 (r375.png), width 25
  .            ######       . 
  .         ##########      . 
  .       ##   #########    . 
  .     ##         ######   . 
  .    #             #####  . 
  .   #               ####  . 
  .   #                #### . 
  .  #                  ####. 
  .  #   ### ###   ###  ####. 
  . #      #   #   #     ###. 
  . #     ##   #   ###   ###. 
  . #      #   #     #   ###. 
  . #      #   #     #   ###. 
  . #    ###   # # ###   ###. 
  . #            #       ###. 
  . #                    ###. 
  .  #       #   #      ####. 
  .  #          #       ####. 
  .   #        #       #### . 
  .   #       #       ####  . 
  .    #     #   #     ###  . 
  .     ##           ## #   . 
  .       ##       ##       . 
  .         #######         . 
 __                         __

Char 52 (r500.png), width 25
  .            ######       . 
  .         ##########      . 
  .       ##   #########    . 
  .     ##         ######   . 
  .    #             #####  . 
  .   #               ####  . 
  .   #                #### . 
  .  #                  ####. 
  .  #      ### ###     ####. 
  . #       #   # #      ###. 
  . #       ### # #      ###. 
  . #         # # #      ###. 
  . #         # # #      ###. 
  . #       ### ###      ###. 
  . #                    ###. 
  . #                    ###. 
  .  #       #   #      ####. 
  .  #          #       ####. 
  .   #        #       #### . 
  .   #       #       ####  . 
  .    #     #   #   #####  . 
  .     ##         ######   . 
  .       ##   #########    . 
  .         ##########      . 
 __            ######       __

Char 53 (r625.png), width 25
  .            ######       . 
  .         ##########      . 
  .       ##   #########    . 
  .     ##         ######   . 
  .    #             #####  . 
  .   #               ####  . 
  .   #                #### . 
  .  #                  ####. 
  .  #   ### ###   ###  ####. 
  . #    #     #   #     ###. 
  . #    ### ###   ###   ###. 
  . #    # # #       #   ###. 
  . #    # # #       #   ###. 
  . #    ### ### # ###   ###. 
  . #            #       ###. 
  . #                    ###. 
  .  #       #   #      ####. 
  .  #          #       ####. 
  .   #        #       #### . 
  .   # #     #       ####  . 
  .    ###   #   #   #####  . 
  .   ######       ######   . 
  .    #################    . 
  .      #############      . 
 __       ###########       __

Char 54 (r750.png), width 25
  .            ######       . 
  .         ##########      . 
  .       ##   #########    . 
  .     ##         ######   . 
  .    #             #####  . 
  .   #               ####  . 
  .   #                #### . 
  .  #                  ####. 
  .  #      ### ###     ####. 
  . #         # #        ###. 
  . #         # ###      ###. 
  . #         #   #      ###. 
  .###        #   #      ###. 
  .###        # ###      ###. 
  .###                   ###. 
  .###                   ###. 
  .####      #   #      ####. 
  .####         #       ####. 
  . ####       #       #### . 
  .  ####     #       ####  . 
  .  #####   #   #   #####  . 
  .   ######       ######   . 
  .    #################    . 
  .      #############      . 
 __       ###########       __

Char 55 (r875.png), width 25
  .            ######       . 
  .         ##########      . 
  .       ##   #########    . 
  .   # ##         ######   . 
  .  ###             #####  . 
  .  ####             ####  . 
  . ####               #### . 
  .####                 ####. 
  .####  ### ###   ###  ####. 
  .###   # #   #   #     ###. 
  .###   ###   #   ###   ###. 
  .###   # #   #     #   ###. 
  .###   # #   #     #   ###. 
  .###   ###   # # ###   ###. 
  .###           #       ###. 
  .###                   ###. 
  .####      #   #      ####. 
  .####         #       ####. 
  . ####       #       #### . 
  .  ####     #       ####  . 
  .  #####   #   #   #####  . 
  .   ######       ######   . 
  .    #################    . 
  .      #############      . 
 __       ###########       __

Char 56 (r999.png), width 25
  .       ###########       . 
  .      #############      . 
  .    #################    . 
  .   ######       ######   . 
  .  #####           #####  . 
  .  ####             ####  . 
  . ####               #### . 
  .####                 ####. 
  .####    # ### ###    ####. 
  .###     # # # # #     ###. 
  .###     # # # # #     ###. 
  .###     # # # # #     ###. 
  .###     # # # # #     ###. 
  .###     # ### ###     ###. 
  .###                   ###. 
  .###                   ###. 
  .####      #   #      ####. 
  .####         #       ####. 
  . ####       #       #### . 
  .  ####     #       ####  . 
  .  #####   #   #   #####  . 
  .   ######       ######   . 
  .    #################    . 
  .      #############      . 
 __       ###########       __
