Font: 9x15B (Latin-1-bdf-sources/9x15B.bdf)
Declared name: -Misc-Fixed-Bold-R-Normal--15-140-75-75-C-90-ISO10646-1
Declared family: fixed
Declared weight: bold
Declared size: 15
Matching characters: 22
Height: 14
Baseline: 11
Max width: 9
Fixed width: True

Char: 32 (space), width: 9
  .         .
  .         .
  .         .
  .         .
  .         .
  .         .
  .         .
  .         .
  .         .
  .         .
  _         _
  .         .
  .         .
  .         .

Char: 37 (percent), width: 9
  .         .
  . #    ## .
  .###  ##  .
  .###  ##  .
  . #  ##   .
  .   ##    .
  .   ##    .
  .  ##  #  .
  . ##  ### .
  . ##  ### .
  _##    #  _
  .         .
  .         .
  .         .

Char: 40 (parenleft), width: 9
  .     ##  .
  .    ##   .
  .   ##    .
  .   ##    .
  .  ##     .
  .  ##     .
  .  ##     .
  .  ##     .
  .   ##    .
  .   ##    .
  _    ##   _
  .     ##  .
  .         .
  .         .

Char: 41 (parenright), width: 9
  .  ##     .
  .   ##    .
  .    ##   .
  .    ##   .
  .     ##  .
  .     ##  .
  .     ##  .
  .     ##  .
  .    ##   .
  .    ##   .
  _   ##    _
  .  ##     .
  .         .
  .         .

Char: 42 (asterisk), width: 9
  .         .
  .         .
  .         .
  .         .
  .  ## ##  .
  .   ###   .
  . ####### .
  .   ###   .
  .  ## ##  .
  .         .
  _         _
  .         .
  .         .
  .         .

Char: 43 (plus), width: 9
  .         .
  .         .
  .         .
  .   ##    .
  .   ##    .
  .   ##    .
  .######## .
  .   ##    .
  .   ##    .
  .   ##    .
  _         _
  .         .
  .         .
  .         .

Char: 44 (comma), width: 9
  .         .
  .         .
  .         .
  .         .
  .         .
  .         .
  .         .
  .         .
  .         .
  .   ###   .
  _   ###   _
  .    ##   .
  .    ##   .
  .   ##    .

Char: 45 (hyphen), width: 9
  .         .
  .         .
  .         .
  .         .
  .         .
  .         .
  .######## .
  .         .
  .         .
  .         .
  _         _
  .         .
  .         .
  .         .

Char: 46 (period), width: 9
  .         .
  .         .
  .         .
  .         .
  .         .
  .         .
  .         .
  .         .
  .         .
  .   ##    .
  _  ####   _
  .   ##    .
  .         .
  .         .

Char: 47 (slash), width: 9
  .         .
  .      ## .
  .     ##  .
  .     ##  .
  .    ##   .
  .   ##    .
  .   ##    .
  .  ##     .
  . ##      .
  . ##      .
  _##       _
  .         .
  .         .
  .         .

Char: 48 (zero), width: 9
  .         .
  .   ##    .
  .  ####   .
  . ##  ##  .
  .##    ## .
  .##    ## .
  .##    ## .
  .##    ## .
  . ##  ##  .
  .  ####   .
  _   ##    _
  .         .
  .         .
  .         .

Char: 49 (one), width: 9
  .         .
  .   ##    .
  .  ###    .
  . ####    .
  .   ##    .
  .   ##    .
  .   ##    .
  .   ##    .
  .   ##    .
  .   ##    .
  _ ######  _
  .         .
  .         .
  .         .

Char: 50 (two), width: 9
  .         .
  .  ####   .
  . ##  ##  .
  .##    ## .
  .      ## .
  .     ##  .
  .    ##   .
  .   ##    .
  .  ##     .
  . ##      .
  _######## _
  .         .
  .         .
  .         .

Char: 51 (three), width: 9
  .         .
  . #####   .
  .##   ##  .
  .      ## .
  .     ##  .
  .   ###   .
  .     ##  .
  .      ## .
  .      ## .
  .##   ##  .
  _ #####   _
  .         .
  .         .
  .         .

Char: 52 (four), width: 9
  .         .
  .     ##  .
  .    ###  .
  .   ####  .
  .  ## ##  .
  . ##  ##  .
  .##   ##  .
  .######## .
  .     ##  .
  .     ##  .
  _     ##  _
  .         .
  .         .
  .         .

Char: 53 (five), width: 9
  .         .
  .#######  .
  .##       .
  .##       .
  .## ###   .
  .###  ##  .
  .      ## .
  .      ## .
  .##    ## .
  . ##  ##  .
  _  ####   _
  .         .
  .         .
  .         .

Char: 54 (six), width: 9
  .         .
  .  ####   .
  . ##  ##  .
  .##    #  .
  .##       .
  .## ###   .
  .###  ##  .
  .##    ## .
  .##    ## .
  . ##  ##  .
  _  ####   _
  .         .
  .         .
  .         .

Char: 55 (seven), width: 9
  .         .
  .######## .
  .      ## .
  .      ## .
  .     ##  .
  .    ##   .
  .    ##   .
  .   ##    .
  .   ##    .
  .   ##    .
  _   ##    _
  .         .
  .         .
  .         .

Char: 56 (eight), width: 9
  .         .
  .  ####   .
  . ##  ##  .
  .##    ## .
  . ##  ##  .
  .  ####   .
  . ##  ##  .
  .##    ## .
  .##    ## .
  . ##  ##  .
  _  ####   _
  .         .
  .         .
  .         .

Char: 57 (nine), width: 9
  .         .
  .  ####   .
  . ##  ##  .
  .##    ## .
  .##    ## .
  . ##  ### .
  .  ### ## .
  .      ## .
  . #    ## .
  . ##  ##  .
  _  ####   _
  .         .
  .         .
  .         .

Char: 58 (colon), width: 9
  .         .
  .         .
  .         .
  .         .
  .   ##    .
  .  ####   .
  .   ##    .
  .         .
  .         .
  .   ##    .
  _  ####   _
  .   ##    .
  .         .
  .         .

Char: 176 (degree), width: 9
  .         .
  .   ####  .
  .  ##  ## .
  .  ##  ## .
  .   ####  .
  .         .
  .         .
  .         .
  .         .
  .         .
  _         _
  .         .
  .         .
  .         .
