Font: 8x13B (Latin-1-bdf-sources/8x13B.bdf)
Declared name: -Misc-Fixed-Bold-R-Normal--13-120-75-75-C-80-ISO10646-1
Declared family: fixed
Declared weight: bold
Declared size: 13
Matching characters: 22
Height: 11
Baseline: 10
Max width: 8
Fixed width: True

Char: 32 (space), width: 8
  .        .
  .        .
  .        .
  .        .
  .        .
  .        .
  .        .
  .        .
  .        .
  _        _
  .        .

Char: 37 (percent), width: 8
  .###  ## .
  .# #  ## .
  .### ##  .
  .   ##   .
  .   ##   .
  .  ##    .
  .  ##    .
  . ## ### .
  .##  # # .
  _##  ### _
  .        .

Char: 40 (parenleft), width: 8
  .    ##  .
  .   ##   .
  .  ##    .
  .  ##    .
  . ##     .
  . ##     .
  . ##     .
  .  ##    .
  .  ##    .
  _   ##   _
  .    ##  .

Char: 41 (parenright), width: 8
  . ##     .
  .  ##    .
  .   ##   .
  .   ##   .
  .    ##  .
  .    ##  .
  .    ##  .
  .   ##   .
  .   ##   .
  _  ##    _
  . ##     .

Char: 42 (asterisk), width: 8
  .        .
  .        .
  .   #    .
  .   #    .
  .####### .
  .  ###   .
  .  ###   .
  . ## ##  .
  . #   #  .
  _        _
  .        .

Char: 43 (plus), width: 8
  .        .
  .        .
  .   ##   .
  .   ##   .
  . ###### .
  . ###### .
  .   ##   .
  .   ##   .
  .        .
  _        _
  .        .

Char: 44 (comma), width: 8
  .        .
  .        .
  .        .
  .        .
  .        .
  .        .
  .  ####  .
  .   ###  .
  .   ###  .
  _   ##   _
  .  ##    .

Char: 45 (hyphen), width: 8
  .        .
  .        .
  .        .
  .        .
  .        .
  . ###### .
  .        .
  .        .
  .        .
  _        _
  .        .

Char: 46 (period), width: 8
  .        .
  .        .
  .        .
  .        .
  .        .
  .        .
  .        .
  .   ##   .
  .  ####  .
  _   ##   _
  .        .

Char: 47 (slash), width: 8
  .      # .
  .     ## .
  .     ## .
  .    ##  .
  .   ##   .
  .  ##    .
  . ##     .
  .##      .
  .##      .
  _#       _
  .        .

Char: 48 (zero), width: 8
  .  ###   .
  . ## ##  .
  .##   ## .
  .##   ## .
  .##   ## .
  .##   ## .
  .##   ## .
  .##   ## .
  . ## ##  .
  _  ###   _
  .        .

Char: 49 (one), width: 8
  .   ##   .
  .  ###   .
  . ####   .
  .   ##   .
  .   ##   .
  .   ##   .
  .   ##   .
  .   ##   .
  .   ##   .
  _ ###### _
  .        .

Char: 50 (two), width: 8
  . #####  .
  .##   ## .
  .##   ## .
  .     ## .
  .    ##  .
  .   ##   .
  .  ##    .
  . ##     .
  .##      .
  _####### _
  .        .

Char: 51 (three), width: 8
  .####### .
  .     ## .
  .    ##  .
  .   ##   .
  .  ####  .
  .     ## .
  .     ## .
  .     ## .
  .##   ## .
  _ #####  _
  .        .

Char: 52 (four), width: 8
  .    ##  .
  .   ###  .
  .  ####  .
  . ## ##  .
  .##  ##  .
  .##  ##  .
  .####### .
  .    ##  .
  .    ##  .
  _    ##  _
  .        .

Char: 53 (five), width: 8
  .####### .
  .##      .
  .##      .
  .######  .
  .###  ## .
  .     ## .
  .     ## .
  .     ## .
  .##   ## .
  _ #####  _
  .        .

Char: 54 (six), width: 8
  .  ####  .
  . ##     .
  .##      .
  .##      .
  .######  .
  .###  ## .
  .##   ## .
  .##   ## .
  .###  ## .
  _ #####  _
  .        .

Char: 55 (seven), width: 8
  .####### .
  .     ## .
  .     ## .
  .    ##  .
  .   ##   .
  .   ##   .
  .  ##    .
  .  ##    .
  .  ##    .
  _  ##    _
  .        .

Char: 56 (eight), width: 8
  . #####  .
  .##   ## .
  .##   ## .
  .##   ## .
  . #####  .
  .##   ## .
  .##   ## .
  .##   ## .
  .##   ## .
  _ #####  _
  .        .

Char: 57 (nine), width: 8
  . #####  .
  .##  ### .
  .##   ## .
  .##   ## .
  .##  ### .
  . ###### .
  .     ## .
  .     ## .
  .    ##  .
  _ ####   _
  .        .

Char: 58 (colon), width: 8
  .        .
  .        .
  .   ##   .
  .  ####  .
  .   ##   .
  .        .
  .        .
  .   ##   .
  .  ####  .
  _   ##   _
  .        .

Char: 176 (degree), width: 8
  .  ####  .
  . ##  ## .
  . ##  ## .
  .  ####  .
  .        .
  .        .
  .        .
  .        .
  .        .
  _        _
  .        .
