Font: 6x13 (Latin-1-bdf-sources/6x13.bdf)
Declared name: -misc-fixed-medium-r-semicondensed--13-120-75-75-c-60-iso10646-1
Declared family: fixed
Declared weight: medium
Declared size: 13
Characters: 22
Height: 11
Baseline: 10
Max width: 6
Fixed width: True

Char 32 (space), width 6
  .      . 
  .      . 
  .      . 
  .      . 
  .      . 
  .      . 
  .      . 
  .      . 
  .      . 
 __      __
  .      . 

Char 37 (percent), width 6
  .      . 
  . #  # . 
  .# # # . 
  . # #  . 
  .   #  . 
  .  #   . 
  . #    . 
  . # #  . 
  .# # # . 
 __#  #  __
  .      . 

Char 40 (parenleft), width 6
  .   #  . 
  .  #   . 
  .  #   . 
  . #    . 
  . #    . 
  . #    . 
  . #    . 
  . #    . 
  .  #   . 
 __  #   __
  .   #  . 

Char 41 (parenright), width 6
  . #    . 
  .  #   . 
  .  #   . 
  .   #  . 
  .   #  . 
  .   #  . 
  .   #  . 
  .   #  . 
  .  #   . 
 __  #   __
  . #    . 

Char 42 (asterisk), width 6
  .      . 
  .  #   . 
  .# # # . 
  . ###  . 
  .# # # . 
  .  #   . 
  .      . 
  .      . 
  .      . 
 __      __
  .      . 

Char 43 (plus), width 6
  .      . 
  .      . 
  .      . 
  .  #   . 
  .  #   . 
  .##### . 
  .  #   . 
  .  #   . 
  .      . 
 __      __
  .      . 

Char 44 (comma), width 6
  .      . 
  .      . 
  .      . 
  .      . 
  .      . 
  .      . 
  .      . 
  .      . 
  .  ##  . 
 __  #   __
  . #    . 

Char 45 (hyphen), width 6
  .      . 
  .      . 
  .      . 
  .      . 
  .      . 
  .##### . 
  .      . 
  .      . 
  .      . 
 __      __
  .      . 

Char 46 (period), width 6
  .      . 
  .      . 
  .      . 
  .      . 
  .      . 
  .      . 
  .      . 
  .      . 
  .  #   . 
 __ ###  __
  .  #   . 

Char 47 (slash), width 6
  .      . 
  .    # . 
  .    # . 
  .   #  . 
  .   #  . 
  .  #   . 
  . #    . 
  . #    . 
  .#     . 
 __#     __
  .      . 

Char 48 (zero), width 6
  .      . 
  .  #   . 
  . # #  . 
  .#   # . 
  .#   # . 
  .#   # . 
  .#   # . 
  .#   # . 
  . # #  . 
 __  #   __
  .      . 

Char 49 (one), width 6
  .      . 
  .  #   . 
  . ##   . 
  .# #   . 
  .  #   . 
  .  #   . 
  .  #   . 
  .  #   . 
  .  #   . 
 __##### __
  .      . 

Char 50 (two), width 6
  .      . 
  . ###  . 
  .#   # . 
  .#   # . 
  .    # . 
  .   #  . 
  .  #   . 
  . #    . 
  .#     . 
 __##### __
  .      . 

Char 51 (three), width 6
  .      . 
  .##### . 
  .    # . 
  .   #  . 
  .  #   . 
  . ###  . 
  .    # . 
  .    # . 
  .#   # . 
 __ ###  __
  .      . 

Char 52 (four), width 6
  .      . 
  .   #  . 
  .   #  . 
  .  ##  . 
  . # #  . 
  . # #  . 
  .#  #  . 
  .##### . 
  .   #  . 
 __   #  __
  .      . 

Char 53 (five), width 6
  .      . 
  .##### . 
  .#     . 
  .#     . 
  .# ##  . 
  .##  # . 
  .    # . 
  .    # . 
  .#   # . 
 __ ###  __
  .      . 

Char 54 (six), width 6
  .      . 
  . ###  . 
  .#   # . 
  .#     . 
  .#     . 
  .####  . 
  .#   # . 
  .#   # . 
  .#   # . 
 __ ###  __
  .      . 

Char 55 (seven), width 6
  .      . 
  .##### . 
  .    # . 
  .   #  . 
  .   #  . 
  .  #   . 
  .  #   . 
  . #    . 
  . #    . 
 __ #    __
  .      . 

Char 56 (eight), width 6
  .      . 
  . ###  . 
  .#   # . 
  .#   # . 
  .#   # . 
  . ###  . 
  .#   # . 
  .#   # . 
  .#   # . 
 __ ###  __
  .      . 

Char 57 (nine), width 6
  .      . 
  . ###  . 
  .#   # . 
  .#   # . 
  .#   # . 
  . #### . 
  .    # . 
  .    # . 
  .#   # . 
 __ ###  __
  .      . 

Char 58 (colon), width 6
  .      . 
  .      . 
  .      . 
  .  #   . 
  . ###  . 
  .  #   . 
  .      . 
  .      . 
  .  #   . 
 __ ###  __
  .  #   . 

Char 176 (degree), width 6
  .      . 
  .  ##  . 
  . #  # . 
  . #  # . 
  .  ##  . 
  .      . 
  .      . 
  .      . 
  .      . 
 __      __
  .      . 
