Font: 6x13O (Latin-1-bdf-sources/6x13O.bdf)
Declared name: -Misc-Fixed-Medium-O-SemiCondensed--13-120-75-75-C-60-ISO10646-1
Declared family: fixed
Declared weight: medium
Declared size: 13
Matching characters: 22
Height: 11
Baseline: 10
Max width: 6
Fixed width: True

Char: 32 (space), width: 6
  .      .
  .      .
  .      .
  .      .
  .      .
  .      .
  .      .
  .      .
  .      .
  _      _
  .      .

Char: 37 (percent), width: 6
  .      .
  .  #  #.
  . # # #.
  .  # # .
  .    # .
  .   #  .
  .  #   .
  . # #  .
  .# # # .
  _#  #  _
  .      .

Char: 40 (parenleft), width: 6
  .    # .
  .   #  .
  .  #   .
  .  #   .
  . #    .
  . #    .
  . #    .
  . #    .
  .  #   .
  _  #   _
  .   #  .

Char: 41 (parenright), width: 6
  .  #   .
  .   #  .
  .   #  .
  .    # .
  .    # .
  .    # .
  .    # .
  .   #  .
  .   #  .
  _  #   _
  . #    .

Char: 42 (asterisk), width: 6
  .      .
  .      .
  .   #  .
  . # # #.
  . #####.
  .  ### .
  . #####.
  .# # # .
  .  #   .
  _      _
  .      .

Char: 43 (plus), width: 6
  .      .
  .      .
  .      .
  .   #  .
  .   #  .
  . #### .
  .  #   .
  .  #   .
  .      .
  _      _
  .      .

Char: 44 (comma), width: 6
  .      .
  .      .
  .      .
  .      .
  .      .
  .      .
  .      .
  .      .
  .  ##  .
  _  #   _
  . #    .

Char: 45 (hyphen), width: 6
  .      .
  .      .
  .      .
  .      .
  .      .
  . #### .
  .      .
  .      .
  .      .
  _      _
  .      .

Char: 46 (period), width: 6
  .      .
  .      .
  .      .
  .      .
  .      .
  .      .
  .      .
  .      .
  .  #   .
  _ ###  _
  .  #   .

Char: 47 (slash), width: 6
  .      .
  .     #.
  .     #.
  .    # .
  .   #  .
  .   #  .
  .  #   .
  . #    .
  .#     .
  _#     _
  .      .

Char: 48 (zero), width: 6
  .      .
  .   #  .
  .  # # .
  . #   #.
  . #   #.
  . #   #.
  .#   # .
  .#   # .
  . # #  .
  _  #   _
  .      .

Char: 49 (one), width: 6
  .      .
  .   #  .
  .  ##  .
  . # #  .
  .   #  .
  .   #  .
  .  #   .
  .  #   .
  .  #   .
  _##### _
  .      .

Char: 50 (two), width: 6
  .      .
  .  ### .
  . #   #.
  . #   #.
  .    # .
  .   #  .
  .  #   .
  . #    .
  .#     .
  _##### _
  .      .

Char: 51 (three), width: 6
  .      .
  . #####.
  .     #.
  .    # .
  .   #  .
  .  ### .
  .     #.
  .    # .
  .#   # .
  _ ###  _
  .      .

Char: 52 (four), width: 6
  .      .
  .    # .
  .    # .
  .   ## .
  .  # # .
  .  # # .
  . #  # .
  .##### .
  .   #  .
  _   #  _
  .      .

Char: 53 (five), width: 6
  .      .
  . #####.
  . #    .
  . #    .
  . # ## .
  . ##  #.
  .     #.
  .    # .
  .#   # .
  _ ###  _
  .      .

Char: 54 (six), width: 6
  .      .
  .  ### .
  . #   #.
  . #    .
  . #    .
  . ###  .
  .#   # .
  .#   # .
  .#   # .
  _ ###  _
  .      .

Char: 55 (seven), width: 6
  .      .
  . #####.
  .     #.
  .    # .
  .    # .
  .   #  .
  .  #   .
  .  #   .
  . #    .
  _ #    _
  .      .

Char: 56 (eight), width: 6
  .      .
  .  ### .
  . #   #.
  . #   #.
  . #   #.
  . #### .
  .#   # .
  .#   # .
  .#   # .
  _ ###  _
  .      .

Char: 57 (nine), width: 6
  .      .
  .  ### .
  . #   #.
  . #   #.
  . #   #.
  .  ### .
  .    # .
  .    # .
  .#   # .
  _ ###  _
  .      .

Char: 58 (colon), width: 6
  .      .
  .      .
  .      .
  .   #  .
  .  ### .
  .   #  .
  .      .
  .      .
  .  #   .
  _ ###  _
  .  #   .

Char: 176 (degree), width: 6
  .      .
  .  ##  .
  . #  # .
  . #  # .
  .  ##  .
  .      .
  .      .
  .      .
  .      .
  _      _
  .      .
