Font: _7x13O (Latin-1-bdf-sources/7x13O.bdf)
Declared name: -Misc-Fixed-Medium-O-Normal--13-120-75-75-C-70-ISO10646-1
Declared family: fixed
Declared weight: medium
Declared size: 13
Matching characters: 22
Height: 10
Baseline: 9
Max width: 7
Fixed width: True

Char: 32 (space), width: 7
  .       .
  .       .
  .       .
  .       .
  .       .
  .       .
  .       .
  .       .
  _       _
  .       .

Char: 37 (percent), width: 7
  .  #   #.
  . # #  #.
  .  #  # .
  .    #  .
  .   #   .
  .  #    .
  . #  #  .
  .#  # # .
  _#   #  _
  .       .

Char: 40 (parenleft), width: 7
  .    #  .
  .   #   .
  .  #    .
  .  #    .
  . #     .
  . #     .
  .  #    .
  .  #    .
  _   #   _
  .       .

Char: 41 (parenright), width: 7
  .  #    .
  .   #   .
  .   #   .
  .    #  .
  .    #  .
  .   #   .
  .   #   .
  .  #    .
  _ #     _
  .       .

Char: 42 (asterisk), width: 7
  .       .
  .       .
  .  #  # .
  .   ##  .
  . ##### .
  .  ##   .
  . #  #  .
  .       .
  _       _
  .       .

Char: 43 (plus), width: 7
  .       .
  .       .
  .   #   .
  .   #   .
  . ####  .
  .  #    .
  .  #    .
  .       .
  _       _
  .       .

Char: 44 (comma), width: 7
  .       .
  .       .
  .       .
  .       .
  .       .
  .       .
  .       .
  .  ###  .
  _  ##   _
  . #     .

Char: 45 (hyphen), width: 7
  .       .
  .       .
  .       .
  .       .
  . ##### .
  .       .
  .       .
  .       .
  _       _
  .       .

Char: 46 (period), width: 7
  .       .
  .       .
  .       .
  .       .
  .       .
  .       .
  .       .
  .   #   .
  _  ###  _
  .   #   .

Char: 47 (slash), width: 7
  .     # .
  .     # .
  .    #  .
  .   #   .
  .   #   .
  .  #    .
  . #     .
  .#      .
  _#      _
  .       .

Char: 48 (zero), width: 7
  .   ##  .
  .  #  # .
  . #    #.
  . #    #.
  . #    #.
  .#    # .
  .#    # .
  . #  #  .
  _  ##   _
  .       .

Char: 49 (one), width: 7
  .    #  .
  .   ##  .
  .  # #  .
  .    #  .
  .    #  .
  .   #   .
  .   #   .
  .   #   .
  _ ##### _
  .       .

Char: 50 (two), width: 7
  .  #### .
  . #    #.
  . #    #.
  .      #.
  .    ## .
  .  ##   .
  . #     .
  .#      .
  _###### _
  .       .

Char: 51 (three), width: 7
  . ######.
  .      #.
  .     # .
  .    #  .
  .   ##  .
  .     # .
  .     # .
  .#    # .
  _ ####  _
  .       .

Char: 52 (four), width: 7
  .     # .
  .    ## .
  .   # # .
  .  #  # .
  . #  #  .
  .#   #  .
  .###### .
  .    #  .
  _    #  _
  .       .

Char: 53 (five), width: 7
  .  #####.
  .  #    .
  .  #    .
  . # ### .
  . ##   #.
  .      #.
  .     # .
  .#    # .
  _ ####  _
  .       .

Char: 54 (six), width: 7
  .   ### .
  .  #    .
  . #     .
  . #     .
  . ####  .
  .#    # .
  .#    # .
  .#    # .
  _ ####  _
  .       .

Char: 55 (seven), width: 7
  .###### .
  .     # .
  .    #  .
  .   #   .
  .  #    .
  . #     .
  . #     .
  .#      .
  _#      _
  .       .

Char: 56 (eight), width: 7
  .  #### .
  . #    #.
  . #    #.
  . #    #.
  . ##### .
  .#    # .
  .#    # .
  .#    # .
  _ ####  _
  .       .

Char: 57 (nine), width: 7
  . ####  .
  .#    # .
  .#    # .
  .#   ## .
  . ### # .
  .    #  .
  .    #  .
  .   #   .
  _###    _
  .       .

Char: 58 (colon), width: 7
  .       .
  .       .
  .   #   .
  .  ###  .
  .   #   .
  .       .
  .       .
  .  #    .
  _ ###   _
  .  #    .

Char: 176 (degree), width: 7
  .  ##   .
  . #  #  .
  . #  #  .
  .  ##   .
  .       .
  .       .
  .       .
  .       .
  _       _
  .       .
