Font: 7x14 (Latin-1-bdf-sources/7x14.bdf)
Declared name: -misc-fixed-medium-r-normal--14-130-75-75-c-70-iso10646-1
Declared family: fixed
Declared weight: medium
Declared size: 14
Characters: 22
Height: 13
Baseline: 11
Max width: 7
Fixed width: True

Char 32 (space), width 7
  .       . 
  .       . 
  .       . 
  .       . 
  .       . 
  .       . 
  .       . 
  .       . 
  .       . 
  .       . 
 __       __
  .       . 
  .       . 

Char 37 (percent), width 7
  .       . 
  . ##  # . 
  .#  # # . 
  .#  ##  . 
  . ###   . 
  .   #   . 
  .  #    . 
  .  ###  . 
  . ##  # . 
  .# #  # . 
 __#  ##  __
  .       . 
  .       . 

Char 40 (parenleft), width 7
  .     # . 
  .    #  . 
  .   #   . 
  .   #   . 
  .  #    . 
  .  #    . 
  .  #    . 
  .  #    . 
  .  #    . 
  .   #   . 
 __   #   __
  .    #  . 
  .     # . 

Char 41 (parenright), width 7
  . #     . 
  .  #    . 
  .   #   . 
  .   #   . 
  .    #  . 
  .    #  . 
  .    #  . 
  .    #  . 
  .    #  . 
  .   #   . 
 __   #   __
  .  #    . 
  . #     . 

Char 42 (asterisk), width 7
  .       . 
  .       . 
  .       . 
  .   #   . 
  . # # # . 
  .  ###  . 
  .   #   . 
  .  ###  . 
  . # # # . 
  .   #   . 
 __       __
  .       . 
  .       . 

Char 43 (plus), width 7
  .       . 
  .       . 
  .       . 
  .   #   . 
  .   #   . 
  .   #   . 
  . ##### . 
  .   #   . 
  .   #   . 
  .   #   . 
 __       __
  .       . 
  .       . 

Char 44 (comma), width 7
  .       . 
  .       . 
  .       . 
  .       . 
  .       . 
  .       . 
  .       . 
  .       . 
  .       . 
  .  ##   . 
 __   #   __
  .   #   . 
  .  #    . 

Char 45 (hyphen), width 7
  .       . 
  .       . 
  .       . 
  .       . 
  .       . 
  .       . 
  . ##### . 
  .       . 
  .       . 
  .       . 
 __       __
  .       . 
  .       . 

Char 46 (period), width 7
  .       . 
  .       . 
  .       . 
  .       . 
  .       . 
  .       . 
  .       . 
  .       . 
  .       . 
  .   #   . 
 __  ###  __
  .   #   . 
  .       . 

Char 47 (slash), width 7
  .     # . 
  .     # . 
  .    #  . 
  .    #  . 
  .   #   . 
  .   #   . 
  .   #   . 
  .  #    . 
  .  #    . 
  . #     . 
 __ #     __
  .#      . 
  .#      . 

Char 48 (zero), width 7
  .       . 
  .  ##   . 
  . #  #  . 
  .#    # . 
  .#    # . 
  .#    # . 
  .#    # . 
  .#    # . 
  .#    # . 
  . #  #  . 
 __  ##   __
  .       . 
  .       . 

Char 49 (one), width 7
  .       . 
  .   #   . 
  .  ##   . 
  . # #   . 
  .   #   . 
  .   #   . 
  .   #   . 
  .   #   . 
  .   #   . 
  .   #   . 
 __ ##### __
  .       . 
  .       . 

Char 50 (two), width 7
  .       . 
  . ####  . 
  .#    # . 
  .#    # . 
  .     # . 
  .    #  . 
  .    #  . 
  .   #   . 
  .  #    . 
  . #     . 
 __###### __
  .       . 
  .       . 

Char 51 (three), width 7
  .       . 
  .###### . 
  .     # . 
  .    #  . 
  .   #   . 
  .  ###  . 
  .     # . 
  .     # . 
  .#    # . 
  .#    # . 
 __ ####  __
  .       . 
  .       . 

Char 52 (four), width 7
  .       . 
  .    #  . 
  .   ##  . 
  .  # #  . 
  .  # #  . 
  . #  #  . 
  . #  #  . 
  .#   #  . 
  .###### . 
  .    #  . 
 __    #  __
  .       . 
  .       . 

Char 53 (five), width 7
  .       . 
  .###### . 
  .#      . 
  .#      . 
  .#####  . 
  .#    # . 
  .     # . 
  .     # . 
  .#    # . 
  .#    # . 
 __ ####  __
  .       . 
  .       . 

Char 54 (six), width 7
  .       . 
  .  ###  . 
  . #     . 
  .#      . 
  .#      . 
  .# ###  . 
  .##   # . 
  .#    # . 
  .#    # . 
  .#    # . 
 __ ####  __
  .       . 
  .       . 

Char 55 (seven), width 7
  .       . 
  .###### . 
  .     # . 
  .    #  . 
  .    #  . 
  .   #   . 
  .   #   . 
  .  #    . 
  .  #    . 
  . #     . 
 __ #     __
  .       . 
  .       . 

Char 56 (eight), width 7
  .       . 
  . ####  . 
  .#    # . 
  .#    # . 
  . #  #  . 
  .  ##   . 
  . #  #  . 
  .#    # . 
  .#    # . 
  .#    # . 
 __ ####  __
  .       . 
  .       . 

Char 57 (nine), width 7
  .       . 
  . ####  . 
  .#    # . 
  .#    # . 
  .#    # . 
  .#   ## . 
  . ### # . 
  .     # . 
  .#    # . 
  .#   #  . 
 __ ###   __
  .       . 
  .       . 

Char 58 (colon), width 7
  .       . 
  .       . 
  .       . 
  .   #   . 
  .  ###  . 
  .   #   . 
  .       . 
  .       . 
  .   #   . 
  .  ###  . 
 __   #   __
  .       . 
  .       . 

Char 176 (degree), width 7
  .  ##   . 
  . #  #  . 
  . #  #  . 
  .  ##   . 
  .       . 
  .       . 
  .       . 
  .       . 
  .       . 
  .       . 
 __       __
  .       . 
  .       . 
