Font: spleen_8x16 (Latin-1-bdf-sources/spleen-8x16.bdf)
Declared name: -misc-spleen-medium-r-normal--16-160-72-72-c-80-iso10646-1
Declared family: spleen
Declared weight: medium
Declared size: 16
Characters: 22
Height: 12
Baseline: 11
Max width: 8
Fixed width: True

Char 32 (SPACE), width 8
 __        __
  .        . 
  .        . 
  .        . 
  .        . 
  .        . 
  .        . 
  .        . 
  .        . 
  .        . 
  .        . 
  .        . 

Char 37 (PERCENT SIGN), width 8
 __        __
  .     ## . 
  . ##  ## . 
  . ## ##  . 
  .    ##  . 
  .   ##   . 
  .   ##   . 
  .  ##    . 
  .  ## ## . 
  . ##  ## . 
  . ##     . 
  .        . 

Char 40 (LEFT PARENTHESIS), width 8
 __    ### __
  .   ##   . 
  .  ##    . 
  .  ##    . 
  . ##     . 
  . ##     . 
  . ##     . 
  . ##     . 
  .  ##    . 
  .  ##    . 
  .   ##   . 
  .    ### . 

Char 41 (RIGHT PARENTHESIS), width 8
 __ ###    __
  .   ##   . 
  .    ##  . 
  .    ##  . 
  .     ## . 
  .     ## . 
  .     ## . 
  .     ## . 
  .    ##  . 
  .    ##  . 
  .   ##   . 
  . ###    . 

Char 42 (ASTERISK), width 8
 __        __
  .        . 
  .        . 
  . ##  ## . 
  .  ####  . 
  .   ##   . 
  .########. 
  .   ##   . 
  .  ####  . 
  . ##  ## . 
  .        . 
  .        . 

Char 43 (PLUS SIGN), width 8
 __        __
  .        . 
  .        . 
  .        . 
  .   ##   . 
  .   ##   . 
  . ###### . 
  .   ##   . 
  .   ##   . 
  .        . 
  .        . 
  .        . 

Char 44 (COMMA), width 8
 __        __
  .        . 
  .        . 
  .        . 
  .        . 
  .        . 
  .        . 
  .        . 
  .        . 
  .   ##   . 
  .   ##   . 
  .  ##    . 

Char 45 (HYPHEN-MINUS), width 8
 __        __
  .        . 
  .        . 
  .        . 
  .        . 
  .        . 
  . ###### . 
  .        . 
  .        . 
  .        . 
  .        . 
  .        . 

Char 46 (FULL STOP), width 8
 __        __
  .        . 
  .        . 
  .        . 
  .        . 
  .        . 
  .        . 
  .        . 
  .        . 
  .   ##   . 
  .   ##   . 
  .        . 

Char 47 (SOLIDUS), width 8
 __     ## __
  .     ## . 
  .    ##  . 
  .    ##  . 
  .   ##   . 
  .   ##   . 
  .  ##    . 
  .  ##    . 
  . ##     . 
  . ##     . 
  .##      . 
  .##      . 

Char 48 (DIGIT ZERO), width 8
 __        __
  . #####  . 
  .##   ## . 
  .##   ## . 
  .##  ### . 
  .## #### . 
  .#### ## . 
  .###  ## . 
  .##   ## . 
  .##   ## . 
  . #####  . 
  .        . 

Char 49 (DIGIT ONE), width 8
 __        __
  .   ##   . 
  .  ###   . 
  . ####   . 
  . # ##   . 
  .   ##   . 
  .   ##   . 
  .   ##   . 
  .   ##   . 
  .   ##   . 
  . ###### . 
  .        . 

Char 50 (DIGIT TWO), width 8
 __        __
  . #####  . 
  .##   ## . 
  .     ## . 
  .     ## . 
  .    ##  . 
  .   ##   . 
  .  ##    . 
  . ##     . 
  .##   ## . 
  .####### . 
  .        . 

Char 51 (DIGIT THREE), width 8
 __        __
  . #####  . 
  .##   ## . 
  .     ## . 
  .     ## . 
  .  ####  . 
  .     ## . 
  .     ## . 
  .     ## . 
  .##   ## . 
  . #####  . 
  .        . 

Char 52 (DIGIT FOUR), width 8
 __        __
  .##      . 
  .##      . 
  .##  ##  . 
  .##  ##  . 
  .##  ##  . 
  .##  ##  . 
  .####### . 
  .    ##  . 
  .    ##  . 
  .    ##  . 
  .        . 

Char 53 (DIGIT FIVE), width 8
 __        __
  .####### . 
  .##   ## . 
  .##      . 
  .##      . 
  .######  . 
  .     ## . 
  .     ## . 
  .     ## . 
  .##   ## . 
  . #####  . 
  .        . 

Char 54 (DIGIT SIX), width 8
 __        __
  . #####  . 
  .##   ## . 
  .##      . 
  .##      . 
  .######  . 
  .##   ## . 
  .##   ## . 
  .##   ## . 
  .##   ## . 
  . #####  . 
  .        . 

Char 55 (DIGIT SEVEN), width 8
 __        __
  .####### . 
  .##   ## . 
  .     ## . 
  .     ## . 
  .    ##  . 
  .   ##   . 
  .  ##    . 
  .  ##    . 
  .  ##    . 
  .  ##    . 
  .        . 

Char 56 (DIGIT EIGHT), width 8
 __        __
  . #####  . 
  .##   ## . 
  .##   ## . 
  .##   ## . 
  . #####  . 
  .##   ## . 
  .##   ## . 
  .##   ## . 
  .##   ## . 
  . #####  . 
  .        . 

Char 57 (DIGIT NINE), width 8
 __        __
  . #####  . 
  .##   ## . 
  .##   ## . 
  .##   ## . 
  .##   ## . 
  . ###### . 
  .     ## . 
  .     ## . 
  .##   ## . 
  . #####  . 
  .        . 

Char 58 (COLON), width 8
 __        __
  .        . 
  .        . 
  .        . 
  .   ##   . 
  .   ##   . 
  .        . 
  .        . 
  .        . 
  .   ##   . 
  .   ##   . 
  .        . 

Char 176 (DEGREE SIGN), width 8
 __  ###   __
  . ## ##  . 
  . ## ##  . 
  .  ###   . 
  .        . 
  .        . 
  .        . 
  .        . 
  .        . 
  .        . 
  .        . 
  .        . 
