Font: _helvR14 (Latin-1-bdf-sources/helvR14.bdf)
Declared name: -Adobe-Helvetica-Medium-R-Normal--20-140-100-100-P-100-ISO10646-1
Declared family: helvetica
Declared weight: medium
Declared size: 20
Matching characters: 15
Height: 13
Baseline: 13
Max width: 10
Fixed width: False

Char: 32 (space), width: 5
  .     .
  .     .
  .     .
  .     .
  .     .
  .     .
  .     .
  .     .
  .     .
  .     .
  .     .
  .     .
  _     _

Char: 43 (plus), width: 10
  .          .
  .          .
  .          .
  .   ##     .
  .   ##     .
  .   ##     .
  .   ##     .
  .########  .
  .########  .
  .   ##     .
  .   ##     .
  .   ##     .
  _   ##     _

Char: 45 (hyphen), width: 6
  .      .
  .      .
  .      .
  .      .
  .      .
  .      .
  .      .
  .##### .
  .      .
  .      .
  .      .
  .      .
  _      _

Char: 46 (period), width: 5
  .     .
  .     .
  .     .
  .     .
  .     .
  .     .
  .     .
  .     .
  .     .
  .     .
  .     .
  .##   .
  _##   _

Char: 48 (zero), width: 10
  .  ####    .
  . ######   .
  . ##  ##   .
  .##    ##  .
  .##    ##  .
  .##    ##  .
  .##    ##  .
  .##    ##  .
  .##    ##  .
  .##    ##  .
  . ##  ##   .
  . ######   .
  _  ####    _

Char: 49 (one), width: 10
  .   ##     .
  .#####     .
  .#####     .
  .   ##     .
  .   ##     .
  .   ##     .
  .   ##     .
  .   ##     .
  .   ##     .
  .   ##     .
  .   ##     .
  .   ##     .
  _   ##     _

Char: 50 (two), width: 10
  .  ####    .
  .#######   .
  .##    ##  .
  .      ##  .
  .     ###  .
  .    ###   .
  .   ###    .
  .  ###     .
  . ###      .
  .###       .
  .##        .
  .########  .
  _########  _

Char: 51 (three), width: 10
  .  #####   .
  . #######  .
  .##    ##  .
  .##    ##  .
  .     ##   .
  .   ###    .
  .   ####   .
  .     ###  .
  .      ##  .
  .##    ##  .
  .##   ###  .
  . ######   .
  _  ####    _

Char: 52 (four), width: 10
  .      ##  .
  .     ###  .
  .    ####  .
  .   ## ##  .
  .  ##  ##  .
  .  ##  ##  .
  . ##   ##  .
  .##    ##  .
  .######### .
  .######### .
  .      ##  .
  .      ##  .
  _      ##  _

Char: 53 (five), width: 10
  .#######   .
  .#######   .
  .##        .
  .##        .
  .######    .
  .#######   .
  .##   ###  .
  .      ##  .
  .      ##  .
  .##    ##  .
  .##   ###  .
  .#######   .
  _ #####    _

Char: 54 (six), width: 10
  .  ####    .
  . #######  .
  . ##   ##  .
  .##        .
  .##        .
  .## ###    .
  .#######   .
  .##    ##  .
  .##    ##  .
  .##    ##  .
  .###   ##  .
  . ######   .
  _  ####    _

Char: 55 (seven), width: 10
  .########  .
  .########  .
  .      ##  .
  .     ##   .
  .    ##    .
  .    ##    .
  .   ##     .
  .   ##     .
  .  ##      .
  .  ##      .
  . ##       .
  . ##       .
  _ ##       _

Char: 56 (eight), width: 10
  .  ####    .
  . ######   .
  .###  ###  .
  .##    ##  .
  .##    ##  .
  . ##  ##   .
  . ######   .
  .###  ###  .
  .##    ##  .
  .##    ##  .
  .###  ###  .
  . ######   .
  _  ####    _

Char: 57 (nine), width: 10
  .  ####    .
  . ######   .
  .##   ###  .
  .##    ##  .
  .##    ##  .
  .##    ##  .
  . #######  .
  .  ### ##  .
  .      ##  .
  .      ##  .
  .##   ##   .
  .#######   .
  _ #####    _

Char: 58 (colon), width: 5
  .     .
  .     .
  .     .
  .##   .
  .##   .
  .     .
  .     .
  .     .
  .     .
  .     .
  .     .
  .##   .
  _##   _
