Font: helvR24 (Latin-1-bdf-sources/helvR24.bdf)
Declared name: -adobe-helvetica-medium-r-normal--34-240-100-100-p-176-iso10646-1
Declared family: helvetica
Declared weight: medium
Declared size: 34
Characters: 15
Height: 24
Baseline: 24
Max width: 19
Fixed width: False

Char 32 (space), width 9
  .         . 
  .         . 
  .         . 
  .         . 
  .         . 
  .         . 
  .         . 
  .         . 
  .         . 
  .         . 
  .         . 
  .         . 
  .         . 
  .         . 
  .         . 
  .         . 
  .         . 
  .         . 
  .         . 
  .         . 
  .         . 
  .         . 
  .         . 
  .         . 

Char 43 (plus), width 19
  .                   . 
  .                   . 
  .                   . 
  .                   . 
  .                   . 
  .                   . 
  .                   . 
  .        ###        . 
  .        ###        . 
  .        ###        . 
  .        ###        . 
  .        ###        . 
  .        ###        . 
  .        ###        . 
  . ################# . 
  . ################# . 
  . ################# . 
  .        ###        . 
  .        ###        . 
  .        ###        . 
  .        ###        . 
  .        ###        . 
  .        ###        . 
  .                   . 

Char 45 (hyphen), width 11
  .           . 
  .           . 
  .           . 
  .           . 
  .           . 
  .           . 
  .           . 
  .           . 
  .           . 
  .           . 
  .           . 
  .           . 
  .           . 
  .           . 
  . ########  . 
  . ########  . 
  .           . 
  .           . 
  .           . 
  .           . 
  .           . 
  .           . 
  .           . 
  .           . 

Char 46 (period), width 9
  .         . 
  .         . 
  .         . 
  .         . 
  .         . 
  .         . 
  .         . 
  .         . 
  .         . 
  .         . 
  .         . 
  .         . 
  .         . 
  .         . 
  .         . 
  .         . 
  .         . 
  .         . 
  .         . 
  .         . 
  .   ###   . 
  .   ###   . 
  .   ###   . 
  .   ###   . 

Char 48 (zero), width 18
  .      #####       . 
  .    #########     . 
  .   ###########    . 
  .   ####   ####    . 
  .  ####     ####   . 
  .  ###       ###   . 
  .  ###       ###   . 
  . ###         ###  . 
  . ###         ###  . 
  . ###         ###  . 
  . ###         ###  . 
  . ###         ###  . 
  . ###         ###  . 
  . ###         ###  . 
  . ###         ###  . 
  . ###         ###  . 
  . ###         ###  . 
  .  ###       ###   . 
  .  ###       ###   . 
  .  ###      ####   . 
  .   ####   ####    . 
  .   ###########    . 
  .    #########     . 
  .      #####       . 

Char 49 (one), width 18
  .         ##       . 
  .        ###       . 
  .        ###       . 
  .       ####       . 
  .     ######       . 
  .   ########       . 
  .   ########       . 
  .        ###       . 
  .        ###       . 
  .        ###       . 
  .        ###       . 
  .        ###       . 
  .        ###       . 
  .        ###       . 
  .        ###       . 
  .        ###       . 
  .        ###       . 
  .        ###       . 
  .        ###       . 
  .        ###       . 
  .        ###       . 
  .        ###       . 
  .        ###       . 
  .        ###       . 

Char 50 (two), width 18
  .      #####       . 
  .    #########     . 
  .   ###########    . 
  .  ####     ####   . 
  .  ###       ###   . 
  . ####        ###  . 
  . ###         ###  . 
  . ###         ###  . 
  .             ###  . 
  .            ###   . 
  .           ####   . 
  .          ####    . 
  .         ####     . 
  .       #####      . 
  .      #####       . 
  .    #####         . 
  .   ####           . 
  .  ####            . 
  .  ###             . 
  . ###              . 
  . ###              . 
  . ###############  . 
  . ###############  . 
  . ###############  . 

Char 51 (three), width 18
  .      #####       . 
  .    #########     . 
  .   ###########    . 
  .   ###     ###    . 
  .  ###       ###   . 
  .  ###       ###   . 
  .  ###       ###   . 
  .  ###       ###   . 
  .            ###   . 
  .           ###    . 
  .       #######    . 
  .       ######     . 
  .       #######    . 
  .           ####   . 
  .            ####  . 
  .             ###  . 
  . ###         ###  . 
  . ###         ###  . 
  . ###         ###  . 
  .  ###       ###   . 
  .  ####     ####   . 
  .   ###########    . 
  .    #########     . 
  .      #####       . 

Char 52 (four), width 18
  .           ##     . 
  .          ###     . 
  .         ####     . 
  .         ####     . 
  .        #####     . 
  .       ######     . 
  .      ### ###     . 
  .      ### ###     . 
  .     ###  ###     . 
  .    ###   ###     . 
  .    ###   ###     . 
  .   ###    ###     . 
  .  ###     ###     . 
  .  ###     ###     . 
  . ###      ###     . 
  .###       ###     . 
  .################  . 
  .################  . 
  .################  . 
  .          ###     . 
  .          ###     . 
  .          ###     . 
  .          ###     . 
  .          ###     . 

Char 53 (five), width 18
  .   ############   . 
  .   ############   . 
  .   ############   . 
  .   ###            . 
  .   ###            . 
  .   ###            . 
  .  ###             . 
  .  ###             . 
  .  ### #####       . 
  .  ###########     . 
  .  ############    . 
  .  ####    #####   . 
  .  ###       ###   . 
  .            ####  . 
  .             ###  . 
  .             ###  . 
  .             ###  . 
  . ###         ###  . 
  . ###        ####  . 
  . ####       ###   . 
  .  ####    #####   . 
  .  ############    . 
  .   ##########     . 
  .     #####        . 

Char 54 (six), width 18
  .       ####       . 
  .     ########     . 
  .    ##########    . 
  .   ####    ###    . 
  .   ###      ###   . 
  .  ###       ###   . 
  .  ###             . 
  .  ###             . 
  .  ##              . 
  . ###   ####       . 
  . ### ########     . 
  . #############    . 
  . #####     ####   . 
  . ####       ###   . 
  . ####        ###  . 
  . ###         ###  . 
  . ###         ###  . 
  .  ##         ###  . 
  .  ###        ###  . 
  .  ###       ###   . 
  .   ###     ####   . 
  .   ###########    . 
  .    #########     . 
  .      #####       . 

Char 55 (seven), width 18
  . ###############  . 
  . ###############  . 
  . ###############  . 
  .             ###  . 
  .            ###   . 
  .            ##    . 
  .           ###    . 
  .          ###     . 
  .          ###     . 
  .         ###      . 
  .         ###      . 
  .        ###       . 
  .        ###       . 
  .       ###        . 
  .       ###        . 
  .      ###         . 
  .      ###         . 
  .      ###         . 
  .     ###          . 
  .     ###          . 
  .     ###          . 
  .    ###           . 
  .    ###           . 
  .    ###           . 

Char 56 (eight), width 18
  .      #####       . 
  .    #########     . 
  .   ###########    . 
  .   ###     ####   . 
  .  ###       ###   . 
  .  ###       ###   . 
  .  ###       ###   . 
  .  ###       ###   . 
  .  ####     ####   . 
  .   ####   ####    . 
  .    #########     . 
  .     #######      . 
  .   ###########    . 
  .  ####     ####   . 
  .  ###       ###   . 
  . ###         ###  . 
  . ###         ###  . 
  . ###         ###  . 
  . ###         ###  . 
  . ####       ###   . 
  .  ####     ####   . 
  .   ###########    . 
  .    #########     . 
  .      #####       . 

Char 57 (nine), width 18
  .      #####       . 
  .    #########     . 
  .   ###########    . 
  .  ####    #####   . 
  .  ###      ####   . 
  . ####       ###   . 
  . ###        ####  . 
  . ###         ###  . 
  . ###         ###  . 
  . ###         ###  . 
  . ###        ####  . 
  . ###        ####  . 
  .  ###      #####  . 
  .  ##############  . 
  .   ######### ###  . 
  .     ######  ###  . 
  .             ###  . 
  .            ###   . 
  . ###        ###   . 
  . ####      ####   . 
  .  ####    ####    . 
  .   ##########     . 
  .   #########      . 
  .     #####        . 

Char 58 (colon), width 9
  .         . 
  .         . 
  .         . 
  .         . 
  .         . 
  .         . 
  .    ###  . 
  .    ###  . 
  .    ###  . 
  .    ###  . 
  .         . 
  .         . 
  .         . 
  .         . 
  .         . 
  .         . 
  .         . 
  .         . 
  .         . 
  .         . 
  .    ###  . 
  .    ###  . 
  .    ###  . 
  .    ###  . 
