Font: helvB24 (Latin-1-bdf-sources/helvB24.bdf)
Declared name: -adobe-helvetica-bold-r-normal--34-240-100-100-p-182-iso10646-1
Declared family: helvetica
Declared weight: bold
Declared size: 34
Characters: 15
Height: 24
Baseline: 24
Max width: 19
Fixed width: False

Char 32 (space), width 9
  .         . 
  .         . 
  .         . 
  .         . 
  .         . 
  .         . 
  .         . 
  .         . 
  .         . 
  .         . 
  .         . 
  .         . 
  .         . 
  .         . 
  .         . 
  .         . 
  .         . 
  .         . 
  .         . 
  .         . 
  .         . 
  .         . 
  .         . 
  .         . 

Char 43 (plus), width 19
  .                   . 
  .                   . 
  .                   . 
  .                   . 
  .                   . 
  .                   . 
  .                   . 
  .                   . 
  .       ####        . 
  .       ####        . 
  .       ####        . 
  .       ####        . 
  .       ####        . 
  .       ####        . 
  . ################  . 
  . ################  . 
  . ################  . 
  . ################  . 
  .       ####        . 
  .       ####        . 
  .       ####        . 
  .       ####        . 
  .       ####        . 
  .       ####        . 

Char 45 (hyphen), width 11
  .           . 
  .           . 
  .           . 
  .           . 
  .           . 
  .           . 
  .           . 
  .           . 
  .           . 
  .           . 
  .           . 
  .           . 
  . ######### . 
  . ######### . 
  . ######### . 
  . ######### . 
  . ######### . 
  .           . 
  .           . 
  .           . 
  .           . 
  .           . 
  .           . 
  .           . 

Char 46 (period), width 9
  .         . 
  .         . 
  .         . 
  .         . 
  .         . 
  .         . 
  .         . 
  .         . 
  .         . 
  .         . 
  .         . 
  .         . 
  .         . 
  .         . 
  .         . 
  .         . 
  .         . 
  .         . 
  .         . 
  .  #####  . 
  .  #####  . 
  .  #####  . 
  .  #####  . 
  .  #####  . 

Char 48 (zero), width 18
  .     #######      . 
  .    #########     . 
  .   ###########    . 
  .  #############   . 
  .  #####   #####   . 
  . #####     #####  . 
  . #####     #####  . 
  . #####     #####  . 
  . ####       ####  . 
  . ####       ####  . 
  . ####       ####  . 
  . ####       ####  . 
  . ####       ####  . 
  . ####       ####  . 
  . ####       ####  . 
  . ####       ####  . 
  . #####     #####  . 
  . #####     #####  . 
  . #####     #####  . 
  .  #####   #####   . 
  .  #############   . 
  .   ###########    . 
  .    #########     . 
  .     #######      . 

Char 49 (one), width 18
  .                  . 
  .         ###      . 
  .        ####      . 
  .       #####      . 
  .     #######      . 
  .  ##########      . 
  .  ##########      . 
  .  ##########      . 
  .        ####      . 
  .        ####      . 
  .        ####      . 
  .        ####      . 
  .        ####      . 
  .        ####      . 
  .        ####      . 
  .        ####      . 
  .        ####      . 
  .        ####      . 
  .        ####      . 
  .        ####      . 
  .        ####      . 
  .        ####      . 
  .        ####      . 
  .        ####      . 

Char 50 (two), width 18
  .     #######      . 
  .   ###########    . 
  .  #############   . 
  .  ##############  . 
  . ######   ######  . 
  . #####     ###### . 
  . #####      ##### . 
  . ####       ##### . 
  . ####       ##### . 
  .           ###### . 
  .           #####  . 
  .          ######  . 
  .         ######   . 
  .        ######    . 
  .      #######     . 
  .     #######      . 
  .    ######        . 
  .   ######         . 
  .  ######          . 
  . ######           . 
  . ################ . 
  . ################ . 
  . ################ . 
  . ################ . 

Char 51 (three), width 18
  .     #######      . 
  .   ###########    . 
  .  #############   . 
  .  #############   . 
  . #####     #####  . 
  . ####      #####  . 
  . ####       ####  . 
  . ####       ####  . 
  .           #####  . 
  .          #####   . 
  .       #######    . 
  .       ######     . 
  .       ########   . 
  .          ######  . 
  .           ###### . 
  .            ##### . 
  . ####       ##### . 
  . ####       ##### . 
  . ####      ###### . 
  . #####     #####  . 
  .  ##############  . 
  .  #############   . 
  .   ###########    . 
  .     #######      . 

Char 52 (four), width 18
  .         #####    . 
  .         #####    . 
  .        ######    . 
  .       #######    . 
  .       #######    . 
  .      ########    . 
  .     #### ####    . 
  .     ###  ####    . 
  .    ####  ####    . 
  .    ###   ####    . 
  .   ####   ####    . 
  .  ####    ####    . 
  .  ###     ####    . 
  . ####     ####    . 
  . ###      ####    . 
  . ################ . 
  . ################ . 
  . ################ . 
  . ################ . 
  .          ####    . 
  .          ####    . 
  .          ####    . 
  .          ####    . 
  .          ####    . 

Char 53 (five), width 18
  .   ############   . 
  .   ############   . 
  .   ############   . 
  .   ############   . 
  .   ###            . 
  .  ####            . 
  .  ####            . 
  .  ####            . 
  .  #### #####      . 
  .  ############    . 
  .  #############   . 
  .  #############   . 
  .  ####    ######  . 
  .           #####  . 
  .           #####  . 
  .            ####  . 
  .            ####  . 
  . ####      #####  . 
  . ####      #####  . 
  . #####    #####   . 
  .  #############   . 
  .  ############    . 
  .   ##########     . 
  .     ######       . 

Char 54 (six), width 18
  .      ######      . 
  .    ##########    . 
  .   ############   . 
  .   #############  . 
  .  #####    #####  . 
  .  ####      ####  . 
  . ####             . 
  . ####             . 
  . ####  #####      . 
  . #### ########    . 
  . ##############   . 
  . ##############   . 
  . ######   ######  . 
  . #####     #####  . 
  . ####       ####  . 
  . ####       ####  . 
  . ####       ####  . 
  . ####       ####  . 
  . #####     #####  . 
  .  #####   #####   . 
  .  #############   . 
  .   ###########    . 
  .    #########     . 
  .      #####       . 

Char 55 (seven), width 18
  . ################ . 
  . ################ . 
  . ################ . 
  . ################ . 
  .            ####  . 
  .           #####  . 
  .           ####   . 
  .          ####    . 
  .         #####    . 
  .         ####     . 
  .        #####     . 
  .        ####      . 
  .       #####      . 
  .       ####       . 
  .      #####       . 
  .      #####       . 
  .      ####        . 
  .     #####        . 
  .     #####        . 
  .     #####        . 
  .    #####         . 
  .    #####         . 
  .    #####         . 
  .    #####         . 

Char 56 (eight), width 18
  .     #######      . 
  .   ###########    . 
  .  #############   . 
  .  #####   #####   . 
  . #####     #####  . 
  . ####       ####  . 
  . ####       ####  . 
  . ####       ####  . 
  . #####     #####  . 
  .  #####   #####   . 
  .   ###########    . 
  .   ###########    . 
  .  #############   . 
  . #####     #####  . 
  .#####       ##### . 
  .####         #### . 
  .####         #### . 
  .####         #### . 
  .#####       ##### . 
  . ######   ######  . 
  . ##############   . 
  .  #############   . 
  .   ###########    . 
  .     #######      . 

Char 57 (nine), width 18
  .      #####       . 
  .    #########     . 
  .   ###########    . 
  .  #############   . 
  .  #####   #####   . 
  . #####     #####  . 
  . ####       ####  . 
  . ####       ####  . 
  . ####       ####  . 
  . ####       ####  . 
  . #####     #####  . 
  . ######   ######  . 
  .  ##############  . 
  .  ##############  . 
  .   ######## ####  . 
  .      ####  ####  . 
  .            ####  . 
  .            ####  . 
  . ####      ####   . 
  . #####    #####   . 
  .  ############    . 
  .  ############    . 
  .    #########     . 
  .      #####       . 

Char 58 (colon), width 11
  .           . 
  .           . 
  .           . 
  .           . 
  .           . 
  .           . 
  .           . 
  .   #####   . 
  .   #####   . 
  .   #####   . 
  .   #####   . 
  .   #####   . 
  .           . 
  .           . 
  .           . 
  .           . 
  .           . 
  .           . 
  .           . 
  .   #####   . 
  .   #####   . 
  .   #####   . 
  .   #####   . 
  .   #####   . 
