Font: timR18 (Latin-1-bdf-sources/timR18.bdf)
Declared name: -adobe-times-medium-r-normal--25-180-100-100-p-125-iso10646-1
Declared family: times
Declared weight: medium
Declared size: 25
Characters: 15
Height: 17
Baseline: 17
Max width: 12
Fixed width: False

Char 32 (space), width 6
  .      . 
  .      . 
  .      . 
  .      . 
  .      . 
  .      . 
  .      . 
  .      . 
  .      . 
  .      . 
  .      . 
  .      . 
  .      . 
  .      . 
  .      . 
  .      . 
  .      . 

Char 43 (plus), width 12
  .            . 
  .            . 
  .            . 
  .            . 
  .            . 
  .     ##     . 
  .     ##     . 
  .     ##     . 
  .     ##     . 
  .     ##     . 
  .############. 
  .############. 
  .     ##     . 
  .     ##     . 
  .     ##     . 
  .     ##     . 
  .     ##     . 

Char 45 (hyphen), width 8
  .        . 
  .        . 
  .        . 
  .        . 
  .        . 
  .        . 
  .        . 
  .        . 
  .        . 
  .        . 
  .######  . 
  .######  . 
  .        . 
  .        . 
  .        . 
  .        . 
  .        . 

Char 46 (period), width 6
  .      . 
  .      . 
  .      . 
  .      . 
  .      . 
  .      . 
  .      . 
  .      . 
  .      . 
  .      . 
  .      . 
  .      . 
  .      . 
  .      . 
  .      . 
  .  ##  . 
  .  ##  . 

Char 48 (zero), width 12
  .    ####    . 
  .   ##  ##   . 
  .  ##    ##  . 
  .  ##    ##  . 
  . ##      ## . 
  . ##      ## . 
  . ##      ## . 
  . ##      ## . 
  . ##      ## . 
  . ##      ## . 
  . ##      ## . 
  . ##      ## . 
  . ###    ### . 
  .  ##    ##  . 
  .  ##    ##  . 
  .   ##  ##   . 
  .    ####    . 

Char 49 (one), width 12
  .      #     . 
  .     ##     . 
  .   ####     . 
  .     ##     . 
  .     ##     . 
  .     ##     . 
  .     ##     . 
  .     ##     . 
  .     ##     . 
  .     ##     . 
  .     ##     . 
  .     ##     . 
  .     ##     . 
  .     ##     . 
  .     ##     . 
  .     ##     . 
  .  ########  . 

Char 50 (two), width 12
  .    ###     . 
  .  #######   . 
  .  #    ###  . 
  . #      ##  . 
  . #      ##  . 
  .        ##  . 
  .        ##  . 
  .       ##   . 
  .       ##   . 
  .      ##    . 
  .      #     . 
  .     ##     . 
  .    ##      . 
  .   ##       . 
  .  ##      # . 
  . ########## . 
  . #########  . 

Char 51 (three), width 12
  .    ###     . 
  .  ######    . 
  .  #   ###   . 
  . #     ##   . 
  . #     ##   . 
  .      ##    . 
  .     ##     . 
  .    ####    . 
  .      ###   . 
  .       ###  . 
  .        ##  . 
  .        ##  . 
  .        ##  . 
  .        #   . 
  . ##    ##   . 
  . ###  ##    . 
  .  ####      . 

Char 52 (four), width 12
  .       ##   . 
  .      ###   . 
  .      ###   . 
  .     # ##   . 
  .    ## ##   . 
  .    #  ##   . 
  .   ##  ##   . 
  .   #   ##   . 
  .  ##   ##   . 
  .  #    ##   . 
  . ##    ##   . 
  . ########## . 
  . ########## . 
  .       ##   . 
  .       ##   . 
  .       ##   . 
  .       ##   . 

Char 53 (five), width 12
  .    ####### . 
  .    ######  . 
  .   #        . 
  .   #        . 
  .  ##        . 
  .  ####      . 
  .  ######    . 
  .     #####  . 
  .       ###  . 
  .        ### . 
  .         ## . 
  .         ## . 
  .         ## . 
  .         ## . 
  . ##     ##  . 
  . ###   ###  . 
  .  ######    . 

Char 54 (six), width 12
  .       #### . 
  .     ###    . 
  .    ##      . 
  .   ##       . 
  .  ###       . 
  .  ##        . 
  . ### ###    . 
  . ####  ###  . 
  . ##     ##  . 
  . ##      ## . 
  . ##      ## . 
  . ##      ## . 
  . ##      ## . 
  . ###     ## . 
  .  ##    ##  . 
  .  #### ###  . 
  .    ####    . 

Char 55 (seven), width 12
  .  ######### . 
  . ########## . 
  . ##      ## . 
  . #      ##  . 
  .        ##  . 
  .        #   . 
  .       ##   . 
  .       ##   . 
  .       #    . 
  .      ##    . 
  .      ##    . 
  .      #     . 
  .     ##     . 
  .     ##     . 
  .     ##     . 
  .    ##      . 
  .    ##      . 

Char 56 (eight), width 12
  .    ####    . 
  .   ##  ##   . 
  .  ##    ##  . 
  .  ##    ##  . 
  .  ##    ##  . 
  .  ###  ##   . 
  .   #####    . 
  .    ####    . 
  .   ######   . 
  .  ##   ###  . 
  .  #     ### . 
  . ##      ## . 
  . ##      ## . 
  . ##      ## . 
  . ###    ##  . 
  .  ###  ###  . 
  .    ####    . 

Char 57 (nine), width 12
  .    ####    . 
  .  ### ####  . 
  .  ##    ##  . 
  . ##     ### . 
  . ##      ## . 
  . ##      ## . 
  . ##      ## . 
  . ##      ## . 
  .  ##    ### . 
  .  ###  #### . 
  .    ### ##  . 
  .        ##  . 
  .       ###  . 
  .       ##   . 
  .      ##    . 
  .    ###     . 
  . ####       . 

Char 58 (colon), width 6
  .      . 
  .      . 
  .      . 
  .      . 
  .      . 
  .      . 
  .  ##  . 
  .  ##  . 
  .      . 
  .      . 
  .      . 
  .      . 
  .      . 
  .      . 
  .      . 
  .  ##  . 
  .  ##  . 
