Font: timR24 (Latin-1-bdf-sources/timR24.bdf)
Declared name: -Adobe-Times-Medium-R-Normal--34-240-100-100-P-170-ISO10646-1
Declared family: times
Declared weight: medium
Declared size: 34
Matching characters: 15
Height: 23
Baseline: 23
Max width: 19
Fixed width: False

Char: 32 (space), width: 8
  .        .
  .        .
  .        .
  .        .
  .        .
  .        .
  .        .
  .        .
  .        .
  .        .
  .        .
  .        .
  .        .
  .        .
  .        .
  .        .
  .        .
  .        .
  .        .
  .        .
  .        .
  .        .
  _        _

Char: 43 (plus), width: 19
  .                   .
  .                   .
  .                   .
  .                   .
  .                   .
  .                   .
  .        ##         .
  .        ##         .
  .        ##         .
  .        ##         .
  .        ##         .
  .        ##         .
  .        ##         .
  . ################  .
  . ################  .
  .        ##         .
  .        ##         .
  .        ##         .
  .        ##         .
  .        ##         .
  .        ##         .
  .        ##         .
  _                   _

Char: 45 (hyphen), width: 11
  .           .
  .           .
  .           .
  .           .
  .           .
  .           .
  .           .
  .           .
  .           .
  .           .
  .           .
  .           .
  .           .
  .           .
  . ########  .
  . ########  .
  .           .
  .           .
  .           .
  .           .
  .           .
  .           .
  _           _

Char: 46 (period), width: 8
  .        .
  .        .
  .        .
  .        .
  .        .
  .        .
  .        .
  .        .
  .        .
  .        .
  .        .
  .        .
  .        .
  .        .
  .        .
  .        .
  .        .
  .        .
  .        .
  .   ##   .
  .  ####  .
  .  ####  .
  _   ##   _

Char: 48 (zero), width: 16
  .      ####      .
  .    ###  ###    .
  .   ###    ###   .
  .   ##      ##   .
  .  ###      ###  .
  .  ###      ###  .
  .  ##        ##  .
  . ###        ### .
  . ###        ### .
  . ###        ### .
  . ###        ### .
  . ###        ### .
  . ###        ### .
  . ###        ### .
  . ###        ### .
  . ###        ### .
  . ###        ##  .
  .  ###      ###  .
  .  ###      ###  .
  .   ##      ##   .
  .   ###    ###   .
  .    ###  ###    .
  _      ####      _

Char: 49 (one), width: 16
  .       ##       .
  .      ###       .
  .    #####       .
  .   ## ###       .
  .      ###       .
  .      ###       .
  .      ###       .
  .      ###       .
  .      ###       .
  .      ###       .
  .      ###       .
  .      ###       .
  .      ###       .
  .      ###       .
  .      ###       .
  .      ###       .
  .      ###       .
  .      ###       .
  .      ###       .
  .      ###       .
  .      ###       .
  .     #####      .
  _   #########    _

Char: 50 (two), width: 16
  .     ######     .
  .    ########    .
  .   ###  #####   .
  .  ##      ####  .
  .  #       ####  .
  . ##        ###  .
  . #         ###  .
  .           ###  .
  .           ###  .
  .           ##   .
  .          ###   .
  .          ##    .
  .         ##     .
  .         ##     .
  .        ##      .
  .       ##       .
  .      ##        .
  .     ##         .
  .    ##        # .
  .   ##        ## .
  .  ############  .
  . ############   .
  _#############   _

Char: 51 (three), width: 16
  .      #####     .
  .    ########    .
  .   ##    ####   .
  .  ##      ###   .
  .  #       ###   .
  .          ###   .
  .          ##    .
  .          ##    .
  .         ##     .
  .        ##      .
  .       #####    .
  .     ########   .
  .         #####  .
  .           ###  .
  .           ###  .
  .            ##  .
  .            ##  .
  .            ##  .
  .           ###  .
  .           ##   .
  .  ###     ##    .
  .  ####  ###     .
  _   #######      _

Char: 52 (four), width: 16
  .          ##    .
  .         ###    .
  .         ###    .
  .        ####    .
  .        # ##    .
  .       ## ##    .
  .      ##  ##    .
  .      #   ##    .
  .     ##   ##    .
  .    ##    ##    .
  .    #     ##    .
  .   ##     ##    .
  .  ##      ##    .
  .  #       ##    .
  . ############## .
  . ############## .
  . ############## .
  .          ##    .
  .          ##    .
  .          ##    .
  .          ##    .
  .          ##    .
  _          ##    _

Char: 53 (five), width: 16
  .     #########  .
  .    #########   .
  .    ########    .
  .    #           .
  .   ##           .
  .   #            .
  .  ######        .
  .  ########      .
  .  #########     .
  .      ######    .
  .        ####    .
  .         ####   .
  .          ###   .
  .          ###   .
  .           ##   .
  .           ##   .
  .           ##   .
  .           ##   .
  .          ##    .
  .          ##    .
  . ###     ##     .
  . ####  ###      .
  _  ######        _

Char: 54 (six), width: 16
  .          ####  .
  .        ###     .
  .       ###      .
  .     ####       .
  .    ####        .
  .    ###         .
  .   ###          .
  .  ####          .
  .  ###           .
  .  ###  ####     .
  . #### #######   .
  . #####    ####  .
  . ###       ###  .
  . ###       #### .
  . ###        ### .
  . ###        ### .
  . ###        ### .
  . ###        ### .
  .  ###       ### .
  .  ###       ##  .
  .   ###     ###  .
  .    ###   ##    .
  _      #####     _

Char: 55 (seven), width: 16
  .   ############ .
  .  ############# .
  .  ##        ##  .
  . ##         ##  .
  . #         ###  .
  .           ##   .
  .           ##   .
  .           ##   .
  .          ##    .
  .          ##    .
  .          ##    .
  .         ###    .
  .         ##     .
  .         ##     .
  .        ###     .
  .        ##      .
  .        ##      .
  .        ##      .
  .       ##       .
  .       ##       .
  .       ##       .
  .      ###       .
  _      ##        _

Char: 56 (eight), width: 16
  .    ######      .
  .   ###   ###    .
  .  ###     ###   .
  . ###       ##   .
  . ###       ##   .
  . ###       ##   .
  . ###      ###   .
  . ####     ##    .
  .  #####  ##     .
  .   ######       .
  .    ######      .
  .     ######     .
  .    ## #####    .
  .  ###   #####   .
  .  ##     ####   .
  . ###      ####  .
  . ##       ####  .
  . ##        ###  .
  . ##        ###  .
  . ###       ###  .
  .  ##      ###   .
  .  ###    ###    .
  _    #######     _

Char: 57 (nine), width: 16
  .      ####      .
  .    ##   ###    .
  .   ##     ###   .
  .  ###      ###  .
  .  ##       ###  .
  . ###        ### .
  . ###        ### .
  . ###        ### .
  . ###        ### .
  . ###        ### .
  . ####       ### .
  .  ###       ### .
  .  ####     #### .
  .   ##### ###### .
  .     ##### ###  .
  .           ###  .
  .          ###   .
  .          ###   .
  .         ###    .
  .        ###     .
  .       ###      .
  .     ####       .
  _  ####          _

Char: 58 (colon), width: 9
  .         .
  .         .
  .         .
  .         .
  .         .
  .         .
  .         .
  .         .
  .   ##    .
  .  ####   .
  .  ####   .
  .   ##    .
  .         .
  .         .
  .         .
  .         .
  .         .
  .         .
  .         .
  .   ##    .
  .  ####   .
  .  ####   .
  _   ##    _
