Font: _timB18 (Latin-1-bdf-sources/timB18.bdf)
Declared name: -Adobe-Times-Bold-R-Normal--25-180-100-100-P-132-ISO10646-1
Declared family: times
Declared weight: bold
Declared size: 25
Matching characters: 15
Height: 17
Baseline: 17
Max width: 14
Fixed width: False

Char: 32 (space), width: 6
  .      .
  .      .
  .      .
  .      .
  .      .
  .      .
  .      .
  .      .
  .      .
  .      .
  .      .
  .      .
  .      .
  .      .
  .      .
  .      .
  _      _

Char: 43 (plus), width: 14
  .              .
  .              .
  .              .
  .              .
  .              .
  .     ##       .
  .     ##       .
  .     ##       .
  .     ##       .
  .     ##       .
  .############  .
  .############  .
  .     ##       .
  .     ##       .
  .     ##       .
  .     ##       .
  _     ##       _

Char: 45 (hyphen), width: 8
  .        .
  .        .
  .        .
  .        .
  .        .
  .        .
  .        .
  .        .
  .        .
  .######  .
  .######  .
  .######  .
  .        .
  .        .
  .        .
  .        .
  _        _

Char: 46 (period), width: 6
  .      .
  .      .
  .      .
  .      .
  .      .
  .      .
  .      .
  .      .
  .      .
  .      .
  .      .
  .      .
  .      .
  . ##   .
  .####  .
  .####  .
  _ ##   _

Char: 48 (zero), width: 12
  .    ###     .
  .  ### ###   .
  .  ##   ##   .
  . ###   ###  .
  . ###   ###  .
  .####   #### .
  .####   #### .
  .####   #### .
  .####   #### .
  .####   #### .
  .####   #### .
  . ###   ###  .
  . ###   ###  .
  . ###   ###  .
  .  ##   ##   .
  .  ### ###   .
  _    ###     _

Char: 49 (one), width: 12
  .    ##      .
  .  ####      .
  .######      .
  .   ###      .
  .   ###      .
  .   ###      .
  .   ###      .
  .   ###      .
  .   ###      .
  .   ###      .
  .   ###      .
  .   ###      .
  .   ###      .
  .   ###      .
  .   ###      .
  .  #####     .
  _#########   _

Char: 50 (two), width: 12
  .   ####     .
  .  ######    .
  . ########   .
  .##   ####   .
  .#     ###   .
  .      ###   .
  .      ###   .
  .      ##    .
  .     ###    .
  .     ##     .
  .    ##      .
  .    ##      .
  .   ##    #  .
  .  ##     #  .
  . #########  .
  .##########  .
  _#########   _

Char: 51 (three), width: 12
  .    ####    .
  .  #######   .
  . ##   ####  .
  . #     ###  .
  .       ###  .
  .      ###   .
  .     ###    .
  .   #####    .
  .     #####  .
  .       #### .
  .       #### .
  .        ### .
  .        ### .
  . ##     ### .
  .####   ###  .
  .##### ###   .
  _ ######     _

Char: 52 (four), width: 12
  .       ##   .
  .      ###   .
  .     ####   .
  .     ####   .
  .    #####   .
  .   ## ###   .
  .  ##  ###   .
  .  ##  ###   .
  . ##   ###   .
  .##    ###   .
  .########### .
  .########### .
  .########### .
  .      ###   .
  .      ###   .
  .      ###   .
  _      ###   _

Char: 53 (five), width: 12
  .   ######## .
  .   #######  .
  .  ########  .
  .  ##        .
  .  #         .
  . ###        .
  . #######    .
  . ########   .
  . #########  .
  .     #####  .
  .       ###  .
  .        ##  .
  .        ##  .
  . ##     ##  .
  .####   ##   .
  .##### ###   .
  _ ######     _

Char: 54 (six), width: 12
  .       #### .
  .     ####   .
  .   ####     .
  .  ####      .
  .  ###       .
  . ####       .
  . ### ###    .
  . #### ###   .
  .####   ###  .
  .####   #### .
  .####   #### .
  .####   #### .
  .####   #### .
  . ###   ###  .
  . ###   ###  .
  .  ### ###   .
  _   ####     _

Char: 55 (seven), width: 12
  .  ######### .
  . ########## .
  . #########  .
  .##      ##  .
  .#      ##   .
  .       ##   .
  .      ###   .
  .      ##    .
  .      ##    .
  .     ###    .
  .     ##     .
  .     ##     .
  .    ###     .
  .    ###     .
  .    ##      .
  .   ###      .
  _   ###      _

Char: 56 (eight), width: 12
  .   #####    .
  .  ### ###   .
  . ###   ###  .
  . ###   ###  .
  . ###   ###  .
  . ####  ##   .
  .  ### ##    .
  .  ######    .
  .   ######   .
  .  ## #####  .
  . ##   ####  .
  .###    #### .
  .###    #### .
  .###    #### .
  .####   ###  .
  . #### ###   .
  _  #####     _

Char: 57 (nine), width: 12
  .    ###     .
  .  ### ###   .
  . ###   ###  .
  . ###   ###  .
  .####   #### .
  .####   #### .
  .####   #### .
  .####   #### .
  . ###   #### .
  .  ### ####  .
  .   #######  .
  .      ####  .
  .      ###   .
  .     ####   .
  .    ####    .
  .  ####      .
  _####        _

Char: 58 (colon), width: 8
  .        .
  .        .
  .        .
  .        .
  .        .
  . ##     .
  .####    .
  .####    .
  . ##     .
  .        .
  .        .
  .        .
  .        .
  . ##     .
  .####    .
  .####    .
  _ ##     _
