Font: timB18 (Latin-1-bdf-sources/timB18.bdf)
Declared name: -adobe-times-bold-r-normal--25-180-100-100-p-132-iso10646-1
Declared family: times
Declared weight: bold
Declared size: 25
Characters: 15
Height: 17
Baseline: 17
Max width: 14
Fixed width: False

Char 32 (space), width 6
  .      . 
  .      . 
  .      . 
  .      . 
  .      . 
  .      . 
  .      . 
  .      . 
  .      . 
  .      . 
  .      . 
  .      . 
  .      . 
  .      . 
  .      . 
  .      . 
 __      __

Char 43 (plus), width 14
  .              . 
  .              . 
  .              . 
  .              . 
  .              . 
  .      ##      . 
  .      ##      . 
  .      ##      . 
  .      ##      . 
  .      ##      . 
  . ############ . 
  . ############ . 
  .      ##      . 
  .      ##      . 
  .      ##      . 
  .      ##      . 
 __      ##      __

Char 45 (hyphen), width 8
  .        . 
  .        . 
  .        . 
  .        . 
  .        . 
  .        . 
  .        . 
  .        . 
  .        . 
  . ###### . 
  . ###### . 
  . ###### . 
  .        . 
  .        . 
  .        . 
  .        . 
 __        __

Char 46 (period), width 6
  .      . 
  .      . 
  .      . 
  .      . 
  .      . 
  .      . 
  .      . 
  .      . 
  .      . 
  .      . 
  .      . 
  .      . 
  .      . 
  .  ##  . 
  . #### . 
  . #### . 
 __  ##  __

Char 48 (zero), width 12
  .    ###     . 
  .  ### ###   . 
  .  ##   ##   . 
  . ###   ###  . 
  . ###   ###  . 
  .####   #### . 
  .####   #### . 
  .####   #### . 
  .####   #### . 
  .####   #### . 
  .####   #### . 
  . ###   ###  . 
  . ###   ###  . 
  . ###   ###  . 
  .  ##   ##   . 
  .  ### ###   . 
 __    ###     __

Char 49 (one), width 12
  .      ##    . 
  .    ####    . 
  .  ######    . 
  .     ###    . 
  .     ###    . 
  .     ###    . 
  .     ###    . 
  .     ###    . 
  .     ###    . 
  .     ###    . 
  .     ###    . 
  .     ###    . 
  .     ###    . 
  .     ###    . 
  .     ###    . 
  .    #####   . 
 __  ######### __

Char 50 (two), width 12
  .    ####    . 
  .   ######   . 
  .  ########  . 
  . ##   ####  . 
  . #     ###  . 
  .       ###  . 
  .       ###  . 
  .       ##   . 
  .      ###   . 
  .      ##    . 
  .     ##     . 
  .     ##     . 
  .    ##    # . 
  .   ##     # . 
  .  ######### . 
  . ########## . 
 __ #########  __

Char 51 (three), width 12
  .    ####    . 
  .  #######   . 
  . ##   ####  . 
  . #     ###  . 
  .       ###  . 
  .      ###   . 
  .     ###    . 
  .   #####    . 
  .     #####  . 
  .       #### . 
  .       #### . 
  .        ### . 
  .        ### . 
  . ##     ### . 
  .####   ###  . 
  .##### ###   . 
 __ ######     __

Char 52 (four), width 12
  .       ##   . 
  .      ###   . 
  .     ####   . 
  .     ####   . 
  .    #####   . 
  .   ## ###   . 
  .  ##  ###   . 
  .  ##  ###   . 
  . ##   ###   . 
  .##    ###   . 
  .########### . 
  .########### . 
  .########### . 
  .      ###   . 
  .      ###   . 
  .      ###   . 
 __      ###   __

Char 53 (five), width 12
  .   ######## . 
  .   #######  . 
  .  ########  . 
  .  ##        . 
  .  #         . 
  . ###        . 
  . #######    . 
  . ########   . 
  . #########  . 
  .     #####  . 
  .       ###  . 
  .        ##  . 
  .        ##  . 
  . ##     ##  . 
  .####   ##   . 
  .##### ###   . 
 __ ######     __

Char 54 (six), width 12
  .        ####. 
  .      ####  . 
  .    ####    . 
  .   ####     . 
  .   ###      . 
  .  ####      . 
  .  ### ###   . 
  .  #### ###  . 
  . ####   ### . 
  . ####   ####. 
  . ####   ####. 
  . ####   ####. 
  . ####   ####. 
  .  ###   ### . 
  .  ###   ### . 
  .   ### ###  . 
 __    ####    __

Char 55 (seven), width 12
  .  ######### . 
  . ########## . 
  . #########  . 
  .##      ##  . 
  .#      ##   . 
  .       ##   . 
  .      ###   . 
  .      ##    . 
  .      ##    . 
  .     ###    . 
  .     ##     . 
  .     ##     . 
  .    ###     . 
  .    ###     . 
  .    ##      . 
  .   ###      . 
 __   ###      __

Char 56 (eight), width 12
  .   #####    . 
  .  ### ###   . 
  . ###   ###  . 
  . ###   ###  . 
  . ###   ###  . 
  . ####  ##   . 
  .  ### ##    . 
  .  ######    . 
  .   ######   . 
  .  ## #####  . 
  . ##   ####  . 
  .###    #### . 
  .###    #### . 
  .###    #### . 
  .####   ###  . 
  . #### ###   . 
 __  #####     __

Char 57 (nine), width 12
  .    ###     . 
  .  ### ###   . 
  . ###   ###  . 
  . ###   ###  . 
  .####   #### . 
  .####   #### . 
  .####   #### . 
  .####   #### . 
  . ###   #### . 
  .  ### ####  . 
  .   #######  . 
  .      ####  . 
  .      ###   . 
  .     ####   . 
  .    ####    . 
  .  ####      . 
 __####        __

Char 58 (colon), width 8
  .        . 
  .        . 
  .        . 
  .        . 
  .        . 
  .   ##   . 
  .  ####  . 
  .  ####  . 
  .   ##   . 
  .        . 
  .        . 
  .        . 
  .        . 
  .   ##   . 
  .  ####  . 
  .  ####  . 
 __   ##   __
