Font: timR24 (Latin-1-bdf-sources/timR24.bdf)
Declared name: -adobe-times-medium-r-normal--34-240-100-100-p-170-iso10646-1
Declared family: times
Declared weight: medium
Declared size: 34
Characters: 15
Height: 23
Baseline: 23
Max width: 19
Fixed width: False

Char 32 (space), width 8
  .        . 
  .        . 
  .        . 
  .        . 
  .        . 
  .        . 
  .        . 
  .        . 
  .        . 
  .        . 
  .        . 
  .        . 
  .        . 
  .        . 
  .        . 
  .        . 
  .        . 
  .        . 
  .        . 
  .        . 
  .        . 
  .        . 
 __        __

Char 43 (plus), width 19
  .                   . 
  .                   . 
  .                   . 
  .                   . 
  .                   . 
  .                   . 
  .        ##         . 
  .        ##         . 
  .        ##         . 
  .        ##         . 
  .        ##         . 
  .        ##         . 
  .        ##         . 
  . ################  . 
  . ################  . 
  .        ##         . 
  .        ##         . 
  .        ##         . 
  .        ##         . 
  .        ##         . 
  .        ##         . 
  .        ##         . 
 __                   __

Char 45 (hyphen), width 11
  .           . 
  .           . 
  .           . 
  .           . 
  .           . 
  .           . 
  .           . 
  .           . 
  .           . 
  .           . 
  .           . 
  .           . 
  .           . 
  .           . 
  . ########  . 
  . ########  . 
  .           . 
  .           . 
  .           . 
  .           . 
  .           . 
  .           . 
 __           __

Char 46 (period), width 8
  .        . 
  .        . 
  .        . 
  .        . 
  .        . 
  .        . 
  .        . 
  .        . 
  .        . 
  .        . 
  .        . 
  .        . 
  .        . 
  .        . 
  .        . 
  .        . 
  .        . 
  .        . 
  .        . 
  .   ##   . 
  .  ####  . 
  .  ####  . 
 __   ##   __

Char 48 (zero), width 16
  .      ####      . 
  .    ###  ###    . 
  .   ###    ###   . 
  .   ##      ##   . 
  .  ###      ###  . 
  .  ###      ###  . 
  .  ##        ##  . 
  . ###        ### . 
  . ###        ### . 
  . ###        ### . 
  . ###        ### . 
  . ###        ### . 
  . ###        ### . 
  . ###        ### . 
  . ###        ### . 
  . ###        ### . 
  . ###        ##  . 
  .  ###      ###  . 
  .  ###      ###  . 
  .   ##      ##   . 
  .   ###    ###   . 
  .    ###  ###    . 
 __      ####      __

Char 49 (one), width 16
  .        ##      . 
  .       ###      . 
  .     #####      . 
  .    ## ###      . 
  .       ###      . 
  .       ###      . 
  .       ###      . 
  .       ###      . 
  .       ###      . 
  .       ###      . 
  .       ###      . 
  .       ###      . 
  .       ###      . 
  .       ###      . 
  .       ###      . 
  .       ###      . 
  .       ###      . 
  .       ###      . 
  .       ###      . 
  .       ###      . 
  .       ###      . 
  .      #####     . 
 __    #########   __

Char 50 (two), width 16
  .     ######     . 
  .    ########    . 
  .   ###  #####   . 
  .  ##      ####  . 
  .  #       ####  . 
  . ##        ###  . 
  . #         ###  . 
  .           ###  . 
  .           ###  . 
  .           ##   . 
  .          ###   . 
  .          ##    . 
  .         ##     . 
  .         ##     . 
  .        ##      . 
  .       ##       . 
  .      ##        . 
  .     ##         . 
  .    ##        # . 
  .   ##        ## . 
  .  ############  . 
  . ############   . 
 __#############   __

Char 51 (three), width 16
  .      #####     . 
  .    ########    . 
  .   ##    ####   . 
  .  ##      ###   . 
  .  #       ###   . 
  .          ###   . 
  .          ##    . 
  .          ##    . 
  .         ##     . 
  .        ##      . 
  .       #####    . 
  .     ########   . 
  .         #####  . 
  .           ###  . 
  .           ###  . 
  .            ##  . 
  .            ##  . 
  .            ##  . 
  .           ###  . 
  .           ##   . 
  .  ###     ##    . 
  .  ####  ###     . 
 __   #######      __

Char 52 (four), width 16
  .          ##    . 
  .         ###    . 
  .         ###    . 
  .        ####    . 
  .        # ##    . 
  .       ## ##    . 
  .      ##  ##    . 
  .      #   ##    . 
  .     ##   ##    . 
  .    ##    ##    . 
  .    #     ##    . 
  .   ##     ##    . 
  .  ##      ##    . 
  .  #       ##    . 
  . ############## . 
  . ############## . 
  . ############## . 
  .          ##    . 
  .          ##    . 
  .          ##    . 
  .          ##    . 
  .          ##    . 
 __          ##    __

Char 53 (five), width 16
  .     #########  . 
  .    #########   . 
  .    ########    . 
  .    #           . 
  .   ##           . 
  .   #            . 
  .  ######        . 
  .  ########      . 
  .  #########     . 
  .      ######    . 
  .        ####    . 
  .         ####   . 
  .          ###   . 
  .          ###   . 
  .           ##   . 
  .           ##   . 
  .           ##   . 
  .           ##   . 
  .          ##    . 
  .          ##    . 
  . ###     ##     . 
  . ####  ###      . 
 __  ######        __

Char 54 (six), width 16
  .          ####  . 
  .        ###     . 
  .       ###      . 
  .     ####       . 
  .    ####        . 
  .    ###         . 
  .   ###          . 
  .  ####          . 
  .  ###           . 
  .  ###  ####     . 
  . #### #######   . 
  . #####    ####  . 
  . ###       ###  . 
  . ###       #### . 
  . ###        ### . 
  . ###        ### . 
  . ###        ### . 
  . ###        ### . 
  .  ###       ### . 
  .  ###       ##  . 
  .   ###     ###  . 
  .    ###   ##    . 
 __      #####     __

Char 55 (seven), width 16
  .   ############ . 
  .  ############# . 
  .  ##        ##  . 
  . ##         ##  . 
  . #         ###  . 
  .           ##   . 
  .           ##   . 
  .           ##   . 
  .          ##    . 
  .          ##    . 
  .          ##    . 
  .         ###    . 
  .         ##     . 
  .         ##     . 
  .        ###     . 
  .        ##      . 
  .        ##      . 
  .        ##      . 
  .       ##       . 
  .       ##       . 
  .       ##       . 
  .      ###       . 
 __      ##        __

Char 56 (eight), width 16
  .     ######     . 
  .    ###   ###   . 
  .   ###     ###  . 
  .  ###       ##  . 
  .  ###       ##  . 
  .  ###       ##  . 
  .  ###      ###  . 
  .  ####     ##   . 
  .   #####  ##    . 
  .    ######      . 
  .     ######     . 
  .      ######    . 
  .     ## #####   . 
  .   ###   #####  . 
  .   ##     ####  . 
  .  ###      #### . 
  .  ##       #### . 
  .  ##        ### . 
  .  ##        ### . 
  .  ###       ### . 
  .   ##      ###  . 
  .   ###    ###   . 
 __     #######    __

Char 57 (nine), width 16
  .      ####      . 
  .    ##   ###    . 
  .   ##     ###   . 
  .  ###      ###  . 
  .  ##       ###  . 
  . ###        ### . 
  . ###        ### . 
  . ###        ### . 
  . ###        ### . 
  . ###        ### . 
  . ####       ### . 
  .  ###       ### . 
  .  ####     #### . 
  .   ##### ###### . 
  .     ##### ###  . 
  .           ###  . 
  .          ###   . 
  .          ###   . 
  .         ###    . 
  .        ###     . 
  .       ###      . 
  .     ####       . 
 __  ####          __

Char 58 (colon), width 9
  .         . 
  .         . 
  .         . 
  .         . 
  .         . 
  .         . 
  .         . 
  .         . 
  .   ##    . 
  .  ####   . 
  .  ####   . 
  .   ##    . 
  .         . 
  .         . 
  .         . 
  .         . 
  .         . 
  .         . 
  .         . 
  .   ##    . 
  .  ####   . 
  .  ####   . 
 __   ##    __
