Font: spleen_16x32 (Latin-1-bdf-sources/spleen-16x32.bdf)
Declared name: -misc-spleen-medium-r-normal--32-320-72-72-c-160-iso10646-1
Declared family: spleen
Declared weight: medium
Declared size: 32
Characters: 15
Height: 20
Baseline: 20
Max width: 16
Fixed width: True

Char 32 (SPACE), width 16
  .                . 
  .                . 
  .                . 
  .                . 
  .                . 
  .                . 
  .                . 
  .                . 
  .                . 
  .                . 
  .                . 
  .                . 
  .                . 
  .                . 
  .                . 
  .                . 
  .                . 
  .                . 
  .                . 
  .                . 

Char 43 (PLUS SIGN), width 16
  .                . 
  .                . 
  .                . 
  .                . 
  .                . 
  .                . 
  .       ##       . 
  .       ##       . 
  .       ##       . 
  .       ##       . 
  .   ##########   . 
  .   ##########   . 
  .       ##       . 
  .       ##       . 
  .       ##       . 
  .       ##       . 
  .                . 
  .                . 
  .                . 
  .                . 

Char 45 (HYPHEN-MINUS), width 16
  .                . 
  .                . 
  .                . 
  .                . 
  .                . 
  .                . 
  .                . 
  .                . 
  .                . 
  .                . 
  .  ############  . 
  .  ############  . 
  .                . 
  .                . 
  .                . 
  .                . 
  .                . 
  .                . 
  .                . 
  .                . 

Char 46 (FULL STOP), width 16
  .                . 
  .                . 
  .                . 
  .                . 
  .                . 
  .                . 
  .                . 
  .                . 
  .                . 
  .                . 
  .                . 
  .                . 
  .                . 
  .                . 
  .                . 
  .                . 
  .                . 
  .       ##       . 
  .       ##       . 
  .       ##       . 

Char 48 (DIGIT ZERO), width 16
  .    ########    . 
  .   ##########   . 
  .  ###      ###  . 
  .  ##        ##  . 
  .  ##        ##  . 
  .  ##       ###  . 
  .  ##      ####  . 
  .  ##     #####  . 
  .  ##    ### ##  . 
  .  ##   ###  ##  . 
  .  ##  ###   ##  . 
  .  ## ###    ##  . 
  .  #####     ##  . 
  .  ####      ##  . 
  .  ###       ##  . 
  .  ##        ##  . 
  .  ##        ##  . 
  .  ###      ###  . 
  .   ##########   . 
  .    ########    . 

Char 49 (DIGIT ONE), width 16
  .      ###       . 
  .     ####       . 
  .    ## ##       . 
  .   ##  ##       . 
  .   #   ##       . 
  .       ##       . 
  .       ##       . 
  .       ##       . 
  .       ##       . 
  .       ##       . 
  .       ##       . 
  .       ##       . 
  .       ##       . 
  .       ##       . 
  .       ##       . 
  .       ##       . 
  .       ##       . 
  .       ##       . 
  .   ##########   . 
  .   ##########   . 

Char 50 (DIGIT TWO), width 16
  .    ########    . 
  .   ##########   . 
  .  ###      ###  . 
  .  ##        ##  . 
  .            ##  . 
  .            ##  . 
  .            ##  . 
  .           ##   . 
  .          ##    . 
  .         ##     . 
  .        ##      . 
  .       ##       . 
  .      ##        . 
  .     ##         . 
  .    ##          . 
  .   ##           . 
  .  ##        ##  . 
  .  ##        ##  . 
  .  ############  . 
  .  ############  . 

Char 51 (DIGIT THREE), width 16
  .    ########    . 
  .   ##########   . 
  .  ###      ###  . 
  .  ##        ##  . 
  .            ##  . 
  .            ##  . 
  .            ##  . 
  .           ##   . 
  .     #######    . 
  .     #######    . 
  .           ##   . 
  .            ##  . 
  .            ##  . 
  .            ##  . 
  .            ##  . 
  .            ##  . 
  .  ##        ##  . 
  .  ###      ###  . 
  .   ##########   . 
  .    ########    . 

Char 52 (DIGIT FOUR), width 16
  .  ##            . 
  .  ##            . 
  .  ##            . 
  .  ##            . 
  .  ##      ##    . 
  .  ##      ##    . 
  .  ##      ##    . 
  .  ##      ##    . 
  .  ##      ##    . 
  .  ##      ##    . 
  .  ##      ##    . 
  .  ##      ##    . 
  .  ############  . 
  .  ############  . 
  .          ##    . 
  .          ##    . 
  .          ##    . 
  .          ##    . 
  .          ##    . 
  .          ##    . 

Char 53 (DIGIT FIVE), width 16
  .  ############  . 
  .  ############  . 
  .  ##        ##  . 
  .  ##        ##  . 
  .  ##            . 
  .  ##            . 
  .  ##            . 
  .  ##            . 
  .  ##########    . 
  .  ###########   . 
  .           ###  . 
  .            ##  . 
  .            ##  . 
  .            ##  . 
  .            ##  . 
  .            ##  . 
  .  ##        ##  . 
  .  ###      ###  . 
  .   ##########   . 
  .    ########    . 

Char 54 (DIGIT SIX), width 16
  .    ########    . 
  .   ##########   . 
  .  ###      ###  . 
  .  ##        ##  . 
  .  ##            . 
  .  ##            . 
  .  ##            . 
  .  ##            . 
  .  ##########    . 
  .  ###########   . 
  .  ##       ###  . 
  .  ##        ##  . 
  .  ##        ##  . 
  .  ##        ##  . 
  .  ##        ##  . 
  .  ##        ##  . 
  .  ##        ##  . 
  .  ###      ###  . 
  .   ##########   . 
  .    ########    . 

Char 55 (DIGIT SEVEN), width 16
  .  ############  . 
  .  ############  . 
  .  ##        ##  . 
  .  ##        ##  . 
  .            ##  . 
  .            ##  . 
  .            ##  . 
  .           ##   . 
  .          ##    . 
  .         ##     . 
  .        ##      . 
  .       ##       . 
  .      ##        . 
  .      ##        . 
  .      ##        . 
  .      ##        . 
  .      ##        . 
  .      ##        . 
  .      ##        . 
  .      ##        . 

Char 56 (DIGIT EIGHT), width 16
  .    ########    . 
  .   ##########   . 
  .  ###      ###  . 
  .  ##        ##  . 
  .  ##        ##  . 
  .  ##        ##  . 
  .  ##        ##  . 
  .   ##      ##   . 
  .    ########    . 
  .    ########    . 
  .   ##      ##   . 
  .  ##        ##  . 
  .  ##        ##  . 
  .  ##        ##  . 
  .  ##        ##  . 
  .  ##        ##  . 
  .  ##        ##  . 
  .  ###      ###  . 
  .   ##########   . 
  .    ########    . 

Char 57 (DIGIT NINE), width 16
  .    ########    . 
  .   ##########   . 
  .  ###      ###  . 
  .  ##        ##  . 
  .  ##        ##  . 
  .  ##        ##  . 
  .  ##        ##  . 
  .  ##        ##  . 
  .  ##        ##  . 
  .  ###       ##  . 
  .   ###########  . 
  .    ##########  . 
  .            ##  . 
  .            ##  . 
  .            ##  . 
  .            ##  . 
  .  ##        ##  . 
  .  ###      ###  . 
  .   ##########   . 
  .    ########    . 

Char 58 (COLON), width 16
  .                . 
  .                . 
  .                . 
  .                . 
  .                . 
  .                . 
  .                . 
  .       ##       . 
  .       ##       . 
  .       ##       . 
  .                . 
  .                . 
  .                . 
  .                . 
  .                . 
  .                . 
  .                . 
  .       ##       . 
  .       ##       . 
  .       ##       . 
