Font: spleen_6x12 (Latin-1-bdf-sources/spleen-6x12.bdf)
Declared name: -misc-spleen-medium-r-normal--12-120-72-72-c-60-iso10646-1
Declared family: spleen
Declared weight: medium
Declared size: 12
Characters: 15
Height: 8
Baseline: 8
Max width: 6
Fixed width: True

Char 32 (SPACE), width 6
  .      . 
  .      . 
  .      . 
  .      . 
  .      . 
  .      . 
  .      . 
  .      . 

Char 43 (PLUS SIGN), width 6
  .      . 
  .      . 
  .  #   . 
  .  #   . 
  .##### . 
  .  #   . 
  .  #   . 
  .      . 

Char 45 (HYPHEN-MINUS), width 6
  .      . 
  .      . 
  .      . 
  .      . 
  .##### . 
  .      . 
  .      . 
  .      . 

Char 46 (FULL STOP), width 6
  .      . 
  .      . 
  .      . 
  .      . 
  .      . 
  .      . 
  .      . 
  .  #   . 

Char 48 (DIGIT ZERO), width 6
  . ###  . 
  .#   # . 
  .#  ## . 
  .# # # . 
  .##  # . 
  .#   # . 
  .#   # . 
  . ###  . 

Char 49 (DIGIT ONE), width 6
  .  #   . 
  . ##   . 
  .  #   . 
  .  #   . 
  .  #   . 
  .  #   . 
  .  #   . 
  . ###  . 

Char 50 (DIGIT TWO), width 6
  . ###  . 
  .#   # . 
  .    # . 
  .    # . 
  . ###  . 
  .#     . 
  .#     . 
  .##### . 

Char 51 (DIGIT THREE), width 6
  . ###  . 
  .#   # . 
  .    # . 
  .  ##  . 
  .    # . 
  .    # . 
  .#   # . 
  . ###  . 

Char 52 (DIGIT FOUR), width 6
  .#     . 
  .#     . 
  .#  #  . 
  .#  #  . 
  .#  #  . 
  .##### . 
  .   #  . 
  .   #  . 

Char 53 (DIGIT FIVE), width 6
  .##### . 
  .#     . 
  .#     . 
  .####  . 
  .    # . 
  .    # . 
  .    # . 
  .####  . 

Char 54 (DIGIT SIX), width 6
  . ###  . 
  .#     . 
  .#     . 
  .####  . 
  .#   # . 
  .#   # . 
  .#   # . 
  . ###  . 

Char 55 (DIGIT SEVEN), width 6
  .##### . 
  .#   # . 
  .    # . 
  .   #  . 
  .  #   . 
  .  #   . 
  .  #   . 
  .  #   . 

Char 56 (DIGIT EIGHT), width 6
  . ###  . 
  .#   # . 
  .#   # . 
  . ###  . 
  .#   # . 
  .#   # . 
  .#   # . 
  . ###  . 

Char 57 (DIGIT NINE), width 6
  . ###  . 
  .#   # . 
  .#   # . 
  .#   # . 
  . #### . 
  .    # . 
  .    # . 
  . ###  . 

Char 58 (COLON), width 6
  .      . 
  .      . 
  .      . 
  .  #   . 
  .      . 
  .      . 
  .      . 
  .  #   . 
