Font: spleen_12x24 (Latin-1-bdf-sources/spleen-12x24.bdf)
Declared name: -misc-spleen-medium-r-normal--24-240-72-72-c-120-iso10646-1
Declared family: spleen
Declared weight: medium
Declared size: 24
Characters: 15
Height: 15
Baseline: 15
Max width: 12
Fixed width: True

Char 32 (SPACE), width 12
  .            . 
  .            . 
  .            . 
  .            . 
  .            . 
  .            . 
  .            . 
  .            . 
  .            . 
  .            . 
  .            . 
  .            . 
  .            . 
  .            . 
  .            . 

Char 43 (PLUS SIGN), width 12
  .            . 
  .            . 
  .            . 
  .            . 
  .            . 
  .     ##     . 
  .     ##     . 
  .     ##     . 
  .  ########  . 
  .     ##     . 
  .     ##     . 
  .     ##     . 
  .            . 
  .            . 
  .            . 

Char 45 (HYPHEN-MINUS), width 12
  .            . 
  .            . 
  .            . 
  .            . 
  .            . 
  .            . 
  .            . 
  .            . 
  .  ########  . 
  .            . 
  .            . 
  .            . 
  .            . 
  .            . 
  .            . 

Char 46 (FULL STOP), width 12
  .            . 
  .            . 
  .            . 
  .            . 
  .            . 
  .            . 
  .            . 
  .            . 
  .            . 
  .            . 
  .            . 
  .            . 
  .            . 
  .     ##     . 
  .     ##     . 

Char 48 (DIGIT ZERO), width 12
  .   ######   . 
  .  ##    ##  . 
  . ##      ## . 
  . ##      ## . 
  . ##     ### . 
  . ##    #### . 
  . ##   ## ## . 
  . ##  ##  ## . 
  . ## ##   ## . 
  . ####    ## . 
  . ###     ## . 
  . ##      ## . 
  . ##      ## . 
  .  ##    ##  . 
  .   ######   . 

Char 49 (DIGIT ONE), width 12
  .    ###     . 
  .   ####     . 
  .  ## ##     . 
  .  #  ##     . 
  .     ##     . 
  .     ##     . 
  .     ##     . 
  .     ##     . 
  .     ##     . 
  .     ##     . 
  .     ##     . 
  .     ##     . 
  .     ##     . 
  .     ##     . 
  .  ########  . 

Char 50 (DIGIT TWO), width 12
  .   ######   . 
  .  ##    ##  . 
  . ##      ## . 
  .         ## . 
  .         ## . 
  .         ## . 
  .        ##  . 
  .       ##   . 
  .      ##    . 
  .     ##     . 
  .    ##      . 
  .   ##       . 
  .  ##        . 
  . ##      ## . 
  . ########## . 

Char 51 (DIGIT THREE), width 12
  .   ######   . 
  .  ##    ##  . 
  . ##      ## . 
  .         ## . 
  .         ## . 
  .        ##  . 
  .    #####   . 
  .        ##  . 
  .         ## . 
  .         ## . 
  .         ## . 
  .         ## . 
  . ##      ## . 
  .  ##    ##  . 
  .   ######   . 

Char 52 (DIGIT FOUR), width 12
  . ##         . 
  . ##         . 
  . ##         . 
  . ##    ##   . 
  . ##    ##   . 
  . ##    ##   . 
  . ##    ##   . 
  . ##    ##   . 
  . ##    ##   . 
  . ##    ##   . 
  . ########## . 
  .       ##   . 
  .       ##   . 
  .       ##   . 
  .       ##   . 

Char 53 (DIGIT FIVE), width 12
  . ########## . 
  . ##      ## . 
  . ##         . 
  . ##         . 
  . ##         . 
  . ##         . 
  . ########   . 
  .        ##  . 
  .         ## . 
  .         ## . 
  .         ## . 
  .         ## . 
  . ##      ## . 
  .  ##    ##  . 
  .   ######   . 

Char 54 (DIGIT SIX), width 12
  .   #######  . 
  .  ##     ## . 
  . ##         . 
  . ##         . 
  . ##         . 
  . ##         . 
  . ########   . 
  . ##     ##  . 
  . ##      ## . 
  . ##      ## . 
  . ##      ## . 
  . ##      ## . 
  . ##      ## . 
  .  ##    ##  . 
  .   ######   . 

Char 55 (DIGIT SEVEN), width 12
  . ########## . 
  . ##      ## . 
  .         ## . 
  .         ## . 
  .         ## . 
  .        ##  . 
  .       ##   . 
  .      ##    . 
  .     ##     . 
  .    ##      . 
  .    ##      . 
  .    ##      . 
  .    ##      . 
  .    ##      . 
  .    ##      . 

Char 56 (DIGIT EIGHT), width 12
  .   ######   . 
  .  ##    ##  . 
  . ##      ## . 
  . ##      ## . 
  . ##      ## . 
  .  ##    ##  . 
  .   ######   . 
  .  ##    ##  . 
  . ##      ## . 
  . ##      ## . 
  . ##      ## . 
  . ##      ## . 
  . ##      ## . 
  .  ##    ##  . 
  .   ######   . 

Char 57 (DIGIT NINE), width 12
  .   ######   . 
  .  ##    ##  . 
  . ##      ## . 
  . ##      ## . 
  . ##      ## . 
  . ##      ## . 
  . ##      ## . 
  .  ##     ## . 
  .   ######## . 
  .         ## . 
  .         ## . 
  .         ## . 
  .         ## . 
  . ##     ##  . 
  .  #######   . 

Char 58 (COLON), width 12
  .            . 
  .            . 
  .            . 
  .            . 
  .            . 
  .            . 
  .     ##     . 
  .     ##     . 
  .            . 
  .            . 
  .            . 
  .            . 
  .            . 
  .     ##     . 
  .     ##     . 
