Font: _spleen_8x16 (Latin-1-bdf-sources/spleen-8x16.bdf)
Declared name: -misc-spleen-medium-r-normal--16-160-72-72-C-80-ISO10646-1
Declared family: spleen
Declared weight: medium
Declared size: 16
Matching characters: 15
Height: 10
Baseline: 10
Max width: 8
Fixed width: True

Char: 32 (SPACE), width: 8
  .        .
  .        .
  .        .
  .        .
  .        .
  .        .
  .        .
  .        .
  .        .
  _        _

Char: 43 (PLUS SIGN), width: 8
  .        .
  .        .
  .        .
  .   ##   .
  .   ##   .
  . ###### .
  .   ##   .
  .   ##   .
  .        .
  _        _

Char: 45 (HYPHEN-MINUS), width: 8
  .        .
  .        .
  .        .
  .        .
  .        .
  . ###### .
  .        .
  .        .
  .        .
  _        _

Char: 46 (FULL STOP), width: 8
  .        .
  .        .
  .        .
  .        .
  .        .
  .        .
  .        .
  .        .
  .   ##   .
  _   ##   _

Char: 48 (DIGIT ZERO), width: 8
  . #####  .
  .##   ## .
  .##   ## .
  .##  ### .
  .## #### .
  .#### ## .
  .###  ## .
  .##   ## .
  .##   ## .
  _ #####  _

Char: 49 (DIGIT ONE), width: 8
  .   ##   .
  .  ###   .
  . ####   .
  . # ##   .
  .   ##   .
  .   ##   .
  .   ##   .
  .   ##   .
  .   ##   .
  _ ###### _

Char: 50 (DIGIT TWO), width: 8
  . #####  .
  .##   ## .
  .     ## .
  .     ## .
  .    ##  .
  .   ##   .
  .  ##    .
  . ##     .
  .##   ## .
  _####### _

Char: 51 (DIGIT THREE), width: 8
  . #####  .
  .##   ## .
  .     ## .
  .     ## .
  .  ####  .
  .     ## .
  .     ## .
  .     ## .
  .##   ## .
  _ #####  _

Char: 52 (DIGIT FOUR), width: 8
  .##      .
  .##      .
  .##  ##  .
  .##  ##  .
  .##  ##  .
  .##  ##  .
  .####### .
  .    ##  .
  .    ##  .
  _    ##  _

Char: 53 (DIGIT FIVE), width: 8
  .####### .
  .##   ## .
  .##      .
  .##      .
  .######  .
  .     ## .
  .     ## .
  .     ## .
  .##   ## .
  _ #####  _

Char: 54 (DIGIT SIX), width: 8
  . #####  .
  .##   ## .
  .##      .
  .##      .
  .######  .
  .##   ## .
  .##   ## .
  .##   ## .
  .##   ## .
  _ #####  _

Char: 55 (DIGIT SEVEN), width: 8
  .####### .
  .##   ## .
  .     ## .
  .     ## .
  .    ##  .
  .   ##   .
  .  ##    .
  .  ##    .
  .  ##    .
  _  ##    _

Char: 56 (DIGIT EIGHT), width: 8
  . #####  .
  .##   ## .
  .##   ## .
  .##   ## .
  . #####  .
  .##   ## .
  .##   ## .
  .##   ## .
  .##   ## .
  _ #####  _

Char: 57 (DIGIT NINE), width: 8
  . #####  .
  .##   ## .
  .##   ## .
  .##   ## .
  .##   ## .
  . ###### .
  .     ## .
  .     ## .
  .##   ## .
  _ #####  _

Char: 58 (COLON), width: 8
  .        .
  .        .
  .        .
  .   ##   .
  .   ##   .
  .        .
  .        .
  .        .
  .   ##   .
  _   ##   _
