Font: ncenB24 (Latin-1-bdf-sources/ncenB24.bdf)
Declared name: -Adobe-New Century Schoolbook-Bold-R-Normal--34-240-100-100-P-193-ISO10646-1
Declared family: new century schoolbook
Declared weight: bold
Declared size: 34
Matching characters: 15
Height: 24
Baseline: 24
Max width: 20
Fixed width: False

Char: 32 (space), width: 9
  .         .
  .         .
  .         .
  .         .
  .         .
  .         .
  .         .
  .         .
  .         .
  .         .
  .         .
  .         .
  .         .
  .         .
  .         .
  .         .
  .         .
  .         .
  .         .
  .         .
  .         .
  .         .
  .         .
  _         _

Char: 43 (plus), width: 20
  .                    .
  .                    .
  .                    .
  .                    .
  .                    .
  .                    .
  .                    .
  .        ####        .
  .        ####        .
  .        ####        .
  .        ####        .
  .        ####        .
  .        ####        .
  .  ################  .
  .  ################  .
  .  ################  .
  .  ################  .
  .        ####        .
  .        ####        .
  .        ####        .
  .        ####        .
  .        ####        .
  .        ####        .
  _                    _

Char: 45 (hyphen), width: 11
  .           .
  .           .
  .           .
  .           .
  .           .
  .           .
  .           .
  .           .
  .           .
  .           .
  .           .
  .           .
  .           .
  .           .
  . ########  .
  . ########  .
  . ########  .
  . ########  .
  .           .
  .           .
  .           .
  .           .
  .           .
  _           _

Char: 46 (period), width: 9
  .         .
  .         .
  .         .
  .         .
  .         .
  .         .
  .         .
  .         .
  .         .
  .         .
  .         .
  .         .
  .         .
  .         .
  .         .
  .         .
  .         .
  .         .
  .  ####   .
  . ######  .
  . ######  .
  . ######  .
  . ######  .
  _  ####   _

Char: 48 (zero), width: 19
  .       ####        .
  .     ########      .
  .    ####  ####     .
  .   ####    ####    .
  .  #####    #####   .
  .  ####      ####   .
  . #####      #####  .
  . #####      #####  .
  . #####      #####  .
  . #####      #####  .
  . #####      #####  .
  . #####      #####  .
  . #####      #####  .
  . #####      #####  .
  . #####      #####  .
  . #####      #####  .
  . #####      #####  .
  .  ####      ####   .
  .  ####      ####   .
  .  #####    #####   .
  .   ####    ####    .
  .    ####  ####     .
  .     ########      .
  _       ####        _

Char: 49 (one), width: 19
  .          ##       .
  .        ####       .
  .   #########       .
  .   #########       .
  .       #####       .
  .       #####       .
  .       #####       .
  .       #####       .
  .       #####       .
  .       #####       .
  .       #####       .
  .       #####       .
  .       #####       .
  .       #####       .
  .       #####       .
  .       #####       .
  .       #####       .
  .       #####       .
  .       #####       .
  .       #####       .
  .       #####       .
  .       #####       .
  .   #############   .
  _   #############   _

Char: 50 (two), width: 19
  .     ########      .
  .   ############    .
  .  ####    ######   .
  . ####      ######  .
  . #####      #####  .
  . ######     #####  .
  . ######     #####  .
  . ######     #####  .
  .  #####    ######  .
  .   ###     #####   .
  .          #####    .
  .         #####     .
  .         ####      .
  .        ####       .
  .       ####        .
  .       ###      ## .
  .      ###       ## .
  .     ###        ## .
  .    ###        ### .
  .   ############### .
  .  ###############  .
  .  ###############  .
  . ################  .
  _ ################  _

Char: 51 (three), width: 19
  .     #######       .
  .   ###########     .
  .  ####    #####    .
  . #####     #####   .
  . ######    #####   .
  . ######    #####   .
  . ######    #####   .
  .  ####     #####   .
  .          #####    .
  .          ###      .
  .      ######       .
  .      #####        .
  .         #####     .
  .          ######   .
  .           #####   .
  .           ######  .
  .  ####      #####  .
  . ######     #####  .
  . ######     #####  .
  . ######    ######  .
  . #####     #####   .
  .  ####    ######   .
  .   ###########     .
  _      ######       _

Char: 52 (four), width: 19
  .              #    .
  .             ##    .
  .            ###    .
  .           ####    .
  .          #####    .
  .         ######    .
  .        #######    .
  .        #######    .
  .       ## #####    .
  .      ##  #####    .
  .     ##   #####    .
  .    ###   #####    .
  .   ###    #####    .
  .  ###     #####    .
  . ###      #####    .
  . ##       #####    .
  . ################# .
  . ################# .
  .          #####    .
  .          #####    .
  .          #####    .
  .          #####    .
  .       ########### .
  _       ########### _

Char: 53 (five), width: 19
  .    #############  .
  .   #############   .
  .   #############   .
  .   ############    .
  .   ##########      .
  .   ##              .
  .   ##              .
  .   ##              .
  .   ##              .
  .   ## ######       .
  .   ###########     .
  .   ###    #####    .
  .   ##      #####   .
  .   #       #####   .
  .            #####  .
  .            #####  .
  .   ###      #####  .
  .  #####     #####  .
  . ######     #####  .
  . ######    #####   .
  .  ####     #####   .
  .  ###    ######    .
  .   ##########      .
  _     ######        _

Char: 54 (six), width: 19
  .       ######      .
  .     ##########    .
  .    #####   ####   .
  .   #####   #####   .
  .   ####    #####   .
  .  #####    #####   .
  .  ####      ###    .
  . #####             .
  . #####             .
  . #####             .
  . #####  ######     .
  . ###############   .
  . ######## #######  .
  . ######     #####  .
  . #####      ###### .
  . #####       ##### .
  . #####       ##### .
  . #####       ##### .
  . #####       ##### .
  .  #####     #####  .
  .  #####     #####  .
  .   #####   #####   .
  .    ###########    .
  _      #######      _

Char: 55 (seven), width: 19
  . ################  .
  . ###############   .
  . ###############   .
  . ##############    .
  . ##############    .
  . ##         ##     .
  . ##         ##     .
  . ##        ###     .
  . #        ###      .
  .          ###      .
  .         ####      .
  .         ###       .
  .        ####       .
  .        ####       .
  .       #####       .
  .       ####        .
  .      #####        .
  .      #####        .
  .     ######        .
  .     ######        .
  .     ######        .
  .     ######        .
  .     ######        .
  _      ####         _

Char: 56 (eight), width: 19
  .      #######      .
  .     ##########    .
  .   ####    #####   .
  .   ###      #####  .
  .  ####       ####  .
  .  ####       ####  .
  .  ####       ####  .
  .  #####      ####  .
  .  ######    ####   .
  .  #############    .
  .   ##########      .
  .    ###########    .
  .     ###########   .
  .   ##############  .
  .  ####    #######  .
  . #####      ###### .
  . ####        ##### .
  . ####        ##### .
  . ####        ####  .
  . ####        ####  .
  . #####      ####   .
  .  #####    ####    .
  .   ##########      .
  _      #####        _

Char: 57 (nine), width: 19
  .       ####        .
  .    ##########     .
  .   #####  #####    .
  .  #####    #####   .
  . ######     #####  .
  . #####      #####  .
  . #####       ##### .
  . #####       ##### .
  . #####       ##### .
  . ######     ###### .
  . ######    ####### .
  .  ####### ## ##### .
  .   ########  ##### .
  .    ######   ##### .
  .             ##### .
  .             ##### .
  .  ###        ####  .
  . #####      #####  .
  . ######     #####  .
  . #####      ####   .
  . #####     #####   .
  .  ###    ######    .
  .   ##########      .
  _     ######        _

Char: 58 (colon), width: 9
  .         .
  .         .
  .         .
  .         .
  .         .
  .         .
  .         .
  .         .
  .  ####   .
  . ######  .
  . ######  .
  . ######  .
  . ######  .
  .  ####   .
  .         .
  .         .
  .         .
  .         .
  .  ####   .
  . ######  .
  . ######  .
  . ######  .
  . ######  .
  _  ####   _
