Font: _ncenR18 (Latin-1-bdf-sources/ncenR18.bdf)
Declared name: -Adobe-New Century Schoolbook-Medium-R-Normal--25-180-100-100-P-136-ISO10646-1
Declared family: new century schoolbook
Declared weight: medium
Declared size: 25
Matching characters: 15
Height: 18
Baseline: 18
Max width: 14
Fixed width: False

Char: 32 (space), width: 7
  .       .
  .       .
  .       .
  .       .
  .       .
  .       .
  .       .
  .       .
  .       .
  .       .
  .       .
  .       .
  .       .
  .       .
  .       .
  .       .
  .       .
  _       _

Char: 43 (plus), width: 14
  .              .
  .              .
  .              .
  .              .
  .              .
  .     ##       .
  .     ##       .
  .     ##       .
  .     ##       .
  .     ##       .
  .############  .
  .############  .
  .     ##       .
  .     ##       .
  .     ##       .
  .     ##       .
  .     ##       .
  _              _

Char: 45 (hyphen), width: 8
  .        .
  .        .
  .        .
  .        .
  .        .
  .        .
  .        .
  .        .
  .        .
  .        .
  .######  .
  .######  .
  .        .
  .        .
  .        .
  .        .
  .        .
  _        _

Char: 46 (period), width: 7
  .       .
  .       .
  .       .
  .       .
  .       .
  .       .
  .       .
  .       .
  .       .
  .       .
  .       .
  .       .
  .       .
  .       .
  .       .
  .###    .
  .###    .
  _###    _

Char: 48 (zero), width: 13
  .    ###      .
  .   #   #     .
  .  ##   ##    .
  .  #     #    .
  . ##     ##   .
  . ##     ##   .
  .###     ###  .
  .###     ###  .
  .###     ###  .
  .###     ###  .
  .###     ###  .
  .###     ###  .
  . ##     ##   .
  . ##     ##   .
  .  #     #    .
  .  ##   ##    .
  .   #   #     .
  _    ###      _

Char: 49 (one), width: 13
  .    #        .
  .  ###        .
  .#####        .
  .   ##        .
  .   ##        .
  .   ##        .
  .   ##        .
  .   ##        .
  .   ##        .
  .   ##        .
  .   ##        .
  .   ##        .
  .   ##        .
  .   ##        .
  .   ##        .
  .   ##        .
  .   ##        .
  _########     _

Char: 50 (two), width: 13
  .   #####     .
  . ###   ###   .
  . #      ##   .
  .###     ###  .
  .###     ###  .
  . #      ###  .
  .        ##   .
  .       ###   .
  .       ##    .
  .      ##     .
  .     ##      .
  .    ##       .
  .   ##        .
  .  ##      #  .
  . ##       #  .
  .##       ##  .
  .###########  .
  _###########  _

Char: 51 (three), width: 13
  .   #####     .
  . ##   ###    .
  .##     ###   .
  .###    ###   .
  .###    ###   .
  . #     ##    .
  .       ##    .
  .      ##     .
  .   #####     .
  .       ##    .
  .        ##   .
  .        ###  .
  . #      ###  .
  .###     ###  .
  .###     ##   .
  .##     ###   .
  . ##    ##    .
  _   ####      _

Char: 52 (four), width: 13
  .         #   .
  .        ##   .
  .       ###   .
  .      ####   .
  .     ## ##   .
  .    ##  ##   .
  .    #   ##   .
  .   ##   ##   .
  .  ##    ##   .
  . ##     ##   .
  . #      ##   .
  .##      ##   .
  .#       ##   .
  .############ .
  .        ##   .
  .        ##   .
  .        ##   .
  _      ###### _

Char: 53 (five), width: 13
  . #########   .
  . ########    .
  . #           .
  . #           .
  . #           .
  . #           .
  . #           .
  . # #####     .
  . ##   ###    .
  .        ##   .
  .        ##   .
  .        ###  .
  . ##     ###  .
  .###     ###  .
  .###     ##   .
  . #      ##   .
  . ##    ##    .
  _   #####     _

Char: 54 (six), width: 13
  .    #####    .
  .  ###   ###  .
  .  #     ###  .
  . ##      ##  .
  . ##          .
  . ##          .
  .###          .
  .### ####     .
  .####   ##    .
  .###     ##   .
  .###     ##   .
  .###     ###  .
  .###     ###  .
  . ##     ###  .
  . ##     ##   .
  . ##     ##   .
  .  ##   ##    .
  _   #####     _

Char: 55 (seven), width: 13
  .##########   .
  .##########   .
  .#       #    .
  .#      ##    .
  .       #     .
  .      ##     .
  .      ##     .
  .      #      .
  .     ##      .
  .     ##      .
  .     #       .
  .    ##       .
  .    ##       .
  .    ##       .
  .   ###       .
  .   ###       .
  .   ###       .
  _    #        _

Char: 56 (eight), width: 13
  .   #####     .
  .  ##   ##    .
  .  #     #    .
  . ##     ##   .
  . ##     ##   .
  . ###    ##   .
  .  ###  ##    .
  .  ######     .
  .   #####     .
  .  ## ####    .
  . ##    ###   .
  .##      ###  .
  .##       ##  .
  .##       ##  .
  .##       ##  .
  . ##     ##   .
  . ###   ###   .
  _   #####     _

Char: 57 (nine), width: 13
  .   #####     .
  .  ##   ##    .
  . ###    ##   .
  . ##     ##   .
  .###     ###  .
  .###     ###  .
  .###     ###  .
  . ##     ###  .
  . ###    ###  .
  .  ##   ####  .
  .   #### ###  .
  .        ###  .
  .        ##   .
  .        ##   .
  .##     ###   .
  .###    ##    .
  .###   ###    .
  _  #####      _

Char: 58 (colon), width: 7
  .       .
  .       .
  .       .
  .       .
  .       .
  .       .
  .###    .
  .###    .
  .###    .
  .       .
  .       .
  .       .
  .       .
  .       .
  .       .
  .###    .
  .###    .
  _###    _
