Font: ncenB24 (Latin-1-bdf-sources/ncenB24.bdf)
Declared name: -adobe-new century schoolbook-bold-r-normal--34-240-100-100-p-193-iso10646-1
Declared family: new century schoolbook
Declared weight: bold
Declared size: 34
Characters: 15
Height: 24
Baseline: 24
Max width: 20
Fixed width: False

Char 32 (space), width 9
  .         . 
  .         . 
  .         . 
  .         . 
  .         . 
  .         . 
  .         . 
  .         . 
  .         . 
  .         . 
  .         . 
  .         . 
  .         . 
  .         . 
  .         . 
  .         . 
  .         . 
  .         . 
  .         . 
  .         . 
  .         . 
  .         . 
  .         . 
 __         __

Char 43 (plus), width 20
  .                    . 
  .                    . 
  .                    . 
  .                    . 
  .                    . 
  .                    . 
  .                    . 
  .        ####        . 
  .        ####        . 
  .        ####        . 
  .        ####        . 
  .        ####        . 
  .        ####        . 
  .  ################  . 
  .  ################  . 
  .  ################  . 
  .  ################  . 
  .        ####        . 
  .        ####        . 
  .        ####        . 
  .        ####        . 
  .        ####        . 
  .        ####        . 
 __                    __

Char 45 (hyphen), width 11
  .           . 
  .           . 
  .           . 
  .           . 
  .           . 
  .           . 
  .           . 
  .           . 
  .           . 
  .           . 
  .           . 
  .           . 
  .           . 
  .           . 
  . ########  . 
  . ########  . 
  . ########  . 
  . ########  . 
  .           . 
  .           . 
  .           . 
  .           . 
  .           . 
 __           __

Char 46 (period), width 9
  .         . 
  .         . 
  .         . 
  .         . 
  .         . 
  .         . 
  .         . 
  .         . 
  .         . 
  .         . 
  .         . 
  .         . 
  .         . 
  .         . 
  .         . 
  .         . 
  .         . 
  .         . 
  .  ####   . 
  . ######  . 
  . ######  . 
  . ######  . 
  . ######  . 
 __  ####   __

Char 48 (zero), width 19
  .       ####        . 
  .     ########      . 
  .    ####  ####     . 
  .   ####    ####    . 
  .  #####    #####   . 
  .  ####      ####   . 
  . #####      #####  . 
  . #####      #####  . 
  . #####      #####  . 
  . #####      #####  . 
  . #####      #####  . 
  . #####      #####  . 
  . #####      #####  . 
  . #####      #####  . 
  . #####      #####  . 
  . #####      #####  . 
  . #####      #####  . 
  .  ####      ####   . 
  .  ####      ####   . 
  .  #####    #####   . 
  .   ####    ####    . 
  .    ####  ####     . 
  .     ########      . 
 __       ####        __

Char 49 (one), width 19
  .          ##       . 
  .        ####       . 
  .   #########       . 
  .   #########       . 
  .       #####       . 
  .       #####       . 
  .       #####       . 
  .       #####       . 
  .       #####       . 
  .       #####       . 
  .       #####       . 
  .       #####       . 
  .       #####       . 
  .       #####       . 
  .       #####       . 
  .       #####       . 
  .       #####       . 
  .       #####       . 
  .       #####       . 
  .       #####       . 
  .       #####       . 
  .       #####       . 
  .   #############   . 
 __   #############   __

Char 50 (two), width 19
  .     ########      . 
  .   ############    . 
  .  ####    ######   . 
  . ####      ######  . 
  . #####      #####  . 
  . ######     #####  . 
  . ######     #####  . 
  . ######     #####  . 
  .  #####    ######  . 
  .   ###     #####   . 
  .          #####    . 
  .         #####     . 
  .         ####      . 
  .        ####       . 
  .       ####        . 
  .       ###      ## . 
  .      ###       ## . 
  .     ###        ## . 
  .    ###        ### . 
  .   ############### . 
  .  ###############  . 
  .  ###############  . 
  . ################  . 
 __ ################  __

Char 51 (three), width 19
  .     #######       . 
  .   ###########     . 
  .  ####    #####    . 
  . #####     #####   . 
  . ######    #####   . 
  . ######    #####   . 
  . ######    #####   . 
  .  ####     #####   . 
  .          #####    . 
  .          ###      . 
  .      ######       . 
  .      #####        . 
  .         #####     . 
  .          ######   . 
  .           #####   . 
  .           ######  . 
  .  ####      #####  . 
  . ######     #####  . 
  . ######     #####  . 
  . ######    ######  . 
  . #####     #####   . 
  .  ####    ######   . 
  .   ###########     . 
 __      ######       __

Char 52 (four), width 19
  .             #     . 
  .            ##     . 
  .           ###     . 
  .          ####     . 
  .         #####     . 
  .        ######     . 
  .       #######     . 
  .       #######     . 
  .      ## #####     . 
  .     ##  #####     . 
  .    ##   #####     . 
  .   ###   #####     . 
  .  ###    #####     . 
  . ###     #####     . 
  .###      #####     . 
  .##       #####     . 
  .#################  . 
  .#################  . 
  .         #####     . 
  .         #####     . 
  .         #####     . 
  .         #####     . 
  .      ###########  . 
 __      ###########  __

Char 53 (five), width 19
  .    #############  . 
  .   #############   . 
  .   #############   . 
  .   ############    . 
  .   ##########      . 
  .   ##              . 
  .   ##              . 
  .   ##              . 
  .   ##              . 
  .   ## ######       . 
  .   ###########     . 
  .   ###    #####    . 
  .   ##      #####   . 
  .   #       #####   . 
  .            #####  . 
  .            #####  . 
  .   ###      #####  . 
  .  #####     #####  . 
  . ######     #####  . 
  . ######    #####   . 
  .  ####     #####   . 
  .  ###    ######    . 
  .   ##########      . 
 __     ######        __

Char 54 (six), width 19
  .       ######      . 
  .     ##########    . 
  .    #####   ####   . 
  .   #####   #####   . 
  .   ####    #####   . 
  .  #####    #####   . 
  .  ####      ###    . 
  . #####             . 
  . #####             . 
  . #####             . 
  . #####  ######     . 
  . ###############   . 
  . ######## #######  . 
  . ######     #####  . 
  . #####      ###### . 
  . #####       ##### . 
  . #####       ##### . 
  . #####       ##### . 
  . #####       ##### . 
  .  #####     #####  . 
  .  #####     #####  . 
  .   #####   #####   . 
  .    ###########    . 
 __      #######      __

Char 55 (seven), width 19
  .  ################ . 
  .  ###############  . 
  .  ###############  . 
  .  ##############   . 
  .  ##############   . 
  .  ##         ##    . 
  .  ##         ##    . 
  .  ##        ###    . 
  .  #        ###     . 
  .           ###     . 
  .          ####     . 
  .          ###      . 
  .         ####      . 
  .         ####      . 
  .        #####      . 
  .        ####       . 
  .       #####       . 
  .       #####       . 
  .      ######       . 
  .      ######       . 
  .      ######       . 
  .      ######       . 
  .      ######       . 
 __       ####        __

Char 56 (eight), width 19
  .      #######      . 
  .     ##########    . 
  .   ####    #####   . 
  .   ###      #####  . 
  .  ####       ####  . 
  .  ####       ####  . 
  .  ####       ####  . 
  .  #####      ####  . 
  .  ######    ####   . 
  .  #############    . 
  .   ##########      . 
  .    ###########    . 
  .     ###########   . 
  .   ##############  . 
  .  ####    #######  . 
  . #####      ###### . 
  . ####        ##### . 
  . ####        ##### . 
  . ####        ####  . 
  . ####        ####  . 
  . #####      ####   . 
  .  #####    ####    . 
  .   ##########      . 
 __      #####        __

Char 57 (nine), width 19
  .       ####        . 
  .    ##########     . 
  .   #####  #####    . 
  .  #####    #####   . 
  . ######     #####  . 
  . #####      #####  . 
  . #####       ##### . 
  . #####       ##### . 
  . #####       ##### . 
  . ######     ###### . 
  . ######    ####### . 
  .  ####### ## ##### . 
  .   ########  ##### . 
  .    ######   ##### . 
  .             ##### . 
  .             ##### . 
  .  ###        ####  . 
  . #####      #####  . 
  . ######     #####  . 
  . #####      ####   . 
  . #####     #####   . 
  .  ###    ######    . 
  .   ##########      . 
 __     ######        __

Char 58 (colon), width 9
  .         . 
  .         . 
  .         . 
  .         . 
  .         . 
  .         . 
  .         . 
  .         . 
  .   ####  . 
  .  ###### . 
  .  ###### . 
  .  ###### . 
  .  ###### . 
  .   ####  . 
  .         . 
  .         . 
  .         . 
  .         . 
  .   ####  . 
  .  ###### . 
  .  ###### . 
  .  ###### . 
  .  ###### . 
 __   ####  __
