Font: ncenB18 (Latin-1-bdf-sources/ncenB18.bdf)
Declared name: -adobe-new century schoolbook-bold-r-normal--25-180-100-100-p-149-iso10646-1
Declared family: new century schoolbook
Declared weight: bold
Declared size: 25
Characters: 15
Height: 18
Baseline: 18
Max width: 14
Fixed width: False

Char 32 (space), width 7
  .       . 
  .       . 
  .       . 
  .       . 
  .       . 
  .       . 
  .       . 
  .       . 
  .       . 
  .       . 
  .       . 
  .       . 
  .       . 
  .       . 
  .       . 
  .       . 
  .       . 
 __       __

Char 43 (plus), width 14
  .              . 
  .              . 
  .              . 
  .              . 
  .              . 
  .      ##      . 
  .      ##      . 
  .      ##      . 
  .      ##      . 
  .      ##      . 
  . ############ . 
  . ############ . 
  .      ##      . 
  .      ##      . 
  .      ##      . 
  .      ##      . 
  .      ##      . 
 __              __

Char 45 (hyphen), width 8
  .        . 
  .        . 
  .        . 
  .        . 
  .        . 
  .        . 
  .        . 
  .        . 
  .        . 
  .        . 
  . ###### . 
  . ###### . 
  . ###### . 
  .        . 
  .        . 
  .        . 
  .        . 
 __        __

Char 46 (period), width 7
  .       . 
  .       . 
  .       . 
  .       . 
  .       . 
  .       . 
  .       . 
  .       . 
  .       . 
  .       . 
  .       . 
  .       . 
  .       . 
  .       . 
  .  ###  . 
  . ##### . 
  . ##### . 
 __  ###  __

Char 48 (zero), width 14
  .     ####     . 
  .   ###  ###   . 
  .  ###    ###  . 
  .  ###    ###  . 
  . ####    #### . 
  . ####    #### . 
  . ####    #### . 
  . ####    #### . 
  . ####    #### . 
  . ####    #### . 
  . ####    #### . 
  . ####    #### . 
  . ####    #### . 
  . ####    #### . 
  .  ###    ###  . 
  .  ###    ###  . 
  .   ###  ###   . 
 __     ####     __

Char 49 (one), width 14
  .     ####     . 
  .  #######     . 
  .     ####     . 
  .     ####     . 
  .     ####     . 
  .     ####     . 
  .     ####     . 
  .     ####     . 
  .     ####     . 
  .     ####     . 
  .     ####     . 
  .     ####     . 
  .     ####     . 
  .     ####     . 
  .     ####     . 
  .     ####     . 
  .    ######    . 
 __  ##########  __

Char 50 (two), width 14
  .    #####     . 
  .  ##   ####   . 
  . ###    ####  . 
  . ####   ####  . 
  . ####   ####  . 
  . ####   ####  . 
  .  ##    ####  . 
  .        ###   . 
  .       ####   . 
  .       ###    . 
  .      ###     . 
  .     ###      . 
  .    ##     #  . 
  .   ##      #  . 
  .  ###     ##  . 
  . ###########  . 
  . ###########  . 
 __ ###########  __

Char 51 (three), width 14
  .     #####    . 
  .   ##   ####  . 
  .  ###    ###  . 
  .  ####   #### . 
  .  ####   #### . 
  .  ####   #### . 
  .   ##    ###  . 
  .        ###   . 
  .     ####     . 
  .        ###   . 
  .         ###  . 
  .  ##     #### . 
  . ####    #### . 
  . ####    #### . 
  . ####    #### . 
  . ###     ###  . 
  .  ##    ####  . 
 __    ######    __

Char 52 (four), width 14
  .         ##   . 
  .        ###   . 
  .       ####   . 
  .      #####   . 
  .      #####   . 
  .     ######   . 
  .    ## ####   . 
  .    #  ####   . 
  .   ##  ####   . 
  .  ##   ####   . 
  .  ##   ####   . 
  . ##    ####   . 
  . ############ . 
  . ############ . 
  .       ####   . 
  .       ####   . 
  .       ####   . 
 __     ######## __

Char 53 (five), width 14
  .  ########### . 
  .  ##########  . 
  .  #########   . 
  .  #           . 
  .  #           . 
  .  #           . 
  .  # #####     . 
  .  ###   ###   . 
  .  ##     ###  . 
  .         #### . 
  .         #### . 
  .         #### . 
  .  ##     #### . 
  . ####    #### . 
  . ####    #### . 
  . ####    ###  . 
  .  ##    ###   . 
 __   ######     __

Char 54 (six), width 14
  .     #####    . 
  .   ###   ##   . 
  .  ###   ####  . 
  .  ###   ####  . 
  . ####   ####  . 
  . ####    ##   . 
  . ####         . 
  . #### ####    . 
  . #####  ####  . 
  . ####    ###  . 
  . ####    #### . 
  . ####    #### . 
  . ####    #### . 
  . ####    #### . 
  . ####    #### . 
  .  ###    ###  . 
  .  ####  ####  . 
 __    ######    __

Char 55 (seven), width 14
  . ############ . 
  . ############ . 
  . ###########  . 
  . ##       ##  . 
  . #       ##   . 
  . #      ###   . 
  .       ###    . 
  .       ###    . 
  .      ###     . 
  .      ###     . 
  .     ####     . 
  .     ####     . 
  .    ####      . 
  .    ####      . 
  .    ####      . 
  .    ####      . 
  .    ####      . 
 __     ##       __

Char 56 (eight), width 14
  .     ####     . 
  .   ###  ###   . 
  .  ###    ###  . 
  .  ###    ###  . 
  .  ###    ###  . 
  .  ####   ###  . 
  .  #####  ##   . 
  .   #######    . 
  .    ######    . 
  .   ########   . 
  .  ### ######  . 
  . ###    ##### . 
  . ###     #### . 
  . ###      ### . 
  . ###      ### . 
  . ###      ##  . 
  .  ###    ##   . 
 __    ######    __

Char 57 (nine), width 14
  .    ######    . 
  .  ####  ####  . 
  .  ###    ###  . 
  . ####    #### . 
  . ####    #### . 
  . ####    #### . 
  . ####    #### . 
  . ####    #### . 
  .  ###    #### . 
  .  ####  ##### . 
  .    #### #### . 
  .         #### . 
  .   ##    #### . 
  .  ####   #### . 
  .  ####   ###  . 
  .  ####   ###  . 
  .   ##   ###   . 
 __    #####     __

Char 58 (colon), width 7
  .       . 
  .       . 
  .       . 
  .       . 
  .       . 
  .       . 
  .  ###  . 
  . ##### . 
  . ##### . 
  .  ###  . 
  .       . 
  .       . 
  .       . 
  .       . 
  .  ###  . 
  . ##### . 
  . ##### . 
 __  ###  __
