Font: ncenB14 (Latin-1-bdf-sources/ncenB14.bdf)
Declared name: -Adobe-New Century Schoolbook-Bold-R-Normal--20-140-100-100-P-113-ISO10646-1
Declared family: new century schoolbook
Declared weight: bold
Declared size: 20
Matching characters: 15
Height: 14
Baseline: 14
Max width: 11
Fixed width: False

Char: 32 (space), width: 5
  .     .
  .     .
  .     .
  .     .
  .     .
  .     .
  .     .
  .     .
  .     .
  .     .
  .     .
  .     .
  .     .
  _     _

Char: 43 (plus), width: 11
  .           .
  .           .
  .           .
  .           .
  .    ##     .
  .    ##     .
  .    ##     .
  .    ##     .
  .########## .
  .########## .
  .    ##     .
  .    ##     .
  .    ##     .
  _    ##     _

Char: 45 (hyphen), width: 6
  .      .
  .      .
  .      .
  .      .
  .      .
  .      .
  .      .
  .      .
  .##### .
  .##### .
  .##### .
  .      .
  .      .
  _      _

Char: 46 (period), width: 5
  .     .
  .     .
  .     .
  .     .
  .     .
  .     .
  .     .
  .     .
  .     .
  .     .
  . ##  .
  .#### .
  .#### .
  _ ##  _

Char: 48 (zero), width: 11
  .    ###    .
  .  ### ###  .
  .  ##   ##  .
  . ###   ### .
  . ###   ### .
  . ###   ### .
  . ###   ### .
  . ###   ### .
  . ###   ### .
  . ###   ### .
  . ###   ### .
  .  ##   ##  .
  .  ### ###  .
  _    ###    _

Char: 49 (one), width: 11
  .     ##    .
  .    ###    .
  .  #####    .
  .    ###    .
  .    ###    .
  .    ###    .
  .    ###    .
  .    ###    .
  .    ###    .
  .    ###    .
  .    ###    .
  .    ###    .
  .    ###    .
  _  #######  _

Char: 50 (two), width: 11
  .    ####   .
  .  ##  ###  .
  . ###   ### .
  . ###   ### .
  .  ##   ### .
  .       ### .
  .      ###  .
  .      ###  .
  .     ###   .
  .    ##     .
  .   ##      .
  .  ##     # .
  . ######### .
  _ ######### _

Char: 51 (three), width: 11
  .    ####   .
  .  ##  ###  .
  . ###   ### .
  . ###   ### .
  .  ##   ### .
  .       ##  .
  .    ###    .
  .       ##  .
  .       ### .
  .  ##   ### .
  . ###   ### .
  . ###   ### .
  .  ##  ###  .
  _   #####   _

Char: 52 (four), width: 11
  .        #  .
  .       ##  .
  .      ###  .
  .     ####  .
  .     ####  .
  .    # ###  .
  .   #  ###  .
  .  #   ###  .
  .  #   ###  .
  . #    ###  .
  . ######### .
  .      ###  .
  .      ###  .
  _     ##### _

Char: 53 (five), width: 11
  .  ######## .
  .  #######  .
  .  #        .
  .  #        .
  .  #        .
  .  ######   .
  .  #   ###  .
  .       ### .
  .       ### .
  .  ##   ### .
  . ###   ### .
  . ###   ### .
  .  ##  ###  .
  _   #####   _

Char: 54 (six), width: 11
  .    #####  .
  .  ###  ### .
  .  ##   ### .
  . ###   ##  .
  . ###       .
  . ### ###   .
  . #### ###  .
  . ###   ### .
  . ###   ### .
  . ###   ### .
  . ###   ### .
  .  ##   ### .
  .  ###  ##  .
  _    ###    _

Char: 55 (seven), width: 11
  . ######### .
  . ######### .
  . #      ## .
  . #     ##  .
  .      ##   .
  .      ##   .
  .     ##    .
  .     ##    .
  .    ###    .
  .    ###    .
  .   ###     .
  .   ###     .
  .   ###     .
  _   ###     _

Char: 56 (eight), width: 11
  .    ###    .
  .  ##   ##  .
  . ##     ## .
  . ##     ## .
  . ###    ## .
  . ##### ##  .
  .  ######   .
  .   ######  .
  .  #  ##### .
  . ##    ### .
  . ##     ## .
  . ##     ## .
  . ###   ##  .
  _   ####    _

Char: 57 (nine), width: 11
  .    ###    .
  .  ##  ###  .
  . ###   ##  .
  . ###   ### .
  . ###   ### .
  . ###   ### .
  . ###   ### .
  .  ### #### .
  .   ### ### .
  .       ### .
  .  ##   ### .
  . ###   ##  .
  . ###  ###  .
  _  #####    _

Char: 58 (colon), width: 6
  .      .
  .      .
  .      .
  .      .
  .      .
  .  ##  .
  . #### .
  . #### .
  .  ##  .
  .      .
  .  ##  .
  . #### .
  . #### .
  _  ##  _
