Font: _ncenB12 (Latin-1-bdf-sources/ncenB12.bdf)
Declared name: -Adobe-New Century Schoolbook-Bold-R-Normal--17-120-100-100-P-99-ISO10646-1
Declared family: new century schoolbook
Declared weight: bold
Declared size: 17
Matching characters: 15
Height: 12
Baseline: 12
Max width: 10
Fixed width: False

Char: 32 (space), width: 4
  .    .
  .    .
  .    .
  .    .
  .    .
  .    .
  .    .
  .    .
  .    .
  .    .
  .    .
  _    _

Char: 43 (plus), width: 10
  .          .
  .          .
  .          .
  .          .
  .   ##     .
  .   ##     .
  .   ##     .
  .########  .
  .########  .
  .   ##     .
  .   ##     .
  _   ##     _

Char: 45 (hyphen), width: 5
  .     .
  .     .
  .     .
  .     .
  .     .
  .     .
  .     .
  .#### .
  .#### .
  .     .
  .     .
  _     _

Char: 46 (period), width: 5
  .     .
  .     .
  .     .
  .     .
  .     .
  .     .
  .     .
  .     .
  .     .
  . ##  .
  .#### .
  _ ##  _

Char: 48 (zero), width: 10
  .   ###    .
  .  ## ##   .
  . ##   ##  .
  . ##   ##  .
  .###   ### .
  .###   ### .
  .###   ### .
  .###   ### .
  . ##   ##  .
  . ##   ##  .
  .  ## ##   .
  _   ###    _

Char: 49 (one), width: 10
  .   ##     .
  .#####     .
  .  ###     .
  .  ###     .
  .  ###     .
  .  ###     .
  .  ###     .
  .  ###     .
  .  ###     .
  .  ###     .
  .  ###     .
  _#######   _

Char: 50 (two), width: 10
  .  ####    .
  . #   ##   .
  .###  ###  .
  .###  ###  .
  . #   ###  .
  .    ###   .
  .    ##    .
  .   ##     .
  .  ##   #  .
  . ##    #  .
  .########  .
  _########  _

Char: 51 (three), width: 10
  .  #####   .
  . ##  ###  .
  . ###  ##  .
  .  #   ##  .
  .     ##   .
  .   #####  .
  .     ###  .
  .      ### .
  . ##   ### .
  .####  ### .
  . ##  ###  .
  _  #####   _

Char: 52 (four), width: 10
  .      #   .
  .     ##   .
  .    ###   .
  .   ####   .
  .  # ###   .
  .  # ###   .
  . #  ###   .
  .#   ###   .
  .######### .
  .    ###   .
  .    ###   .
  _  ####### _

Char: 53 (five), width: 10
  . #######  .
  . ######   .
  . #        .
  . #        .
  . #####    .
  . #  ###   .
  .     ###  .
  . #   ###  .
  .###  ###  .
  .###  ###  .
  .##  ###   .
  _ #####    _

Char: 54 (six), width: 10
  .   #####  .
  .  ##  ### .
  . ##  #### .
  . ##   ##  .
  .###       .
  .### ###   .
  .#### ###  .
  .###   ### .
  .###   ### .
  . ##   ### .
  . ### ###  .
  _   ####   _

Char: 55 (seven), width: 10
  .########  .
  .#######   .
  .#    ##   .
  .#    ##   .
  .#    #    .
  .    ##    .
  .    ##    .
  .   ##     .
  .   ##     .
  .  ###     .
  .  ###     .
  _   #      _

Char: 56 (eight), width: 10
  .  ####    .
  . ##  ##   .
  .###  ###  .
  .###  ###  .
  . ##  ##   .
  .  ####    .
  . ##  ##   .
  .###  ###  .
  .###  ###  .
  .###  ###  .
  . ##  ##   .
  _  ####    _

Char: 57 (nine), width: 10
  .  ####    .
  . ### ###  .
  .###   ##  .
  .###   ### .
  .###   ### .
  . ### #### .
  .  ### ### .
  .      ### .
  . ##   ##  .
  .####  ##  .
  .###  ##   .
  _ #####    _

Char: 58 (colon), width: 5
  .     .
  .     .
  .     .
  .     .
  . ##  .
  .#### .
  . ##  .
  .     .
  .     .
  . ##  .
  .#### .
  _ ##  _
