Font: ncenB10 (Latin-1-bdf-sources/ncenB10.bdf)
Declared name: -adobe-new century schoolbook-bold-r-normal--14-100-100-100-p-87-iso10646-1
Declared family: new century schoolbook
Declared weight: bold
Declared size: 14
Characters: 15
Height: 11
Baseline: 11
Max width: 8
Fixed width: False

Char 32 (space), width 4
  .    . 
  .    . 
  .    . 
  .    . 
  .    . 
  .    . 
  .    . 
  .    . 
  .    . 
  .    . 
  .    . 

Char 43 (plus), width 8
  .        . 
  .        . 
  .        . 
  .   #    . 
  .   #    . 
  .   #    . 
  .####### . 
  .   #    . 
  .   #    . 
  .   #    . 
  .        . 

Char 45 (hyphen), width 5
  .     . 
  .     . 
  .     . 
  .     . 
  .     . 
  .     . 
  .#### . 
  .#### . 
  .     . 
  .     . 
  .     . 

Char 46 (period), width 4
  .    . 
  .    . 
  .    . 
  .    . 
  .    . 
  .    . 
  .    . 
  .    . 
  . ## . 
  . ## . 
  . ## . 

Char 48 (zero), width 8
  .  ###   . 
  . ## ##  . 
  .##   ## . 
  .##   ## . 
  .##   ## . 
  .##   ## . 
  .##   ## . 
  .##   ## . 
  .##   ## . 
  . ## ##  . 
  .  ###   . 

Char 49 (one), width 8
  .   ##   . 
  . ####   . 
  .   ##   . 
  .   ##   . 
  .   ##   . 
  .   ##   . 
  .   ##   . 
  .   ##   . 
  .   ##   . 
  .   ##   . 
  .  ####  . 

Char 50 (two), width 8
  . ####   . 
  .##  ### . 
  .##   ## . 
  .     ## . 
  .     ## . 
  .    ##  . 
  .   ##   . 
  .  ##    . 
  . ##   # . 
  .####### . 
  .####### . 

Char 51 (three), width 8
  . ####   . 
  .##  ### . 
  .##   ## . 
  .     ## . 
  .    ##  . 
  .  ####  . 
  .     ## . 
  .     ## . 
  .##   ## . 
  .##  ### . 
  . ####   . 

Char 52 (four), width 8
  .    ##  . 
  .   ###  . 
  .   ###  . 
  .  # ##  . 
  .  # ##  . 
  . #  ##  . 
  . #  ##  . 
  .####### . 
  .    ##  . 
  .    ##  . 
  .   #### . 

Char 53 (five), width 8
  . ###### . 
  . #####  . 
  . #      . 
  . #      . 
  . # ###  . 
  . ## ### . 
  .     ## . 
  .     ## . 
  .##   ## . 
  .##  ### . 
  . ####   . 

Char 54 (six), width 8
  .  ####  . 
  . ##  ## . 
  .##   ## . 
  .##      . 
  .## ###  . 
  .### ### . 
  .##   ## . 
  .##   ## . 
  .##   ## . 
  .###  ## . 
  . ####   . 

Char 55 (seven), width 8
  .####### . 
  .####### . 
  .#    #  . 
  .#   ##  . 
  .    ##  . 
  .   ##   . 
  .   ##   . 
  .   ##   . 
  .  ##    . 
  .  ##    . 
  .  ##    . 

Char 56 (eight), width 8
  . ####   . 
  .###  ## . 
  .##   ## . 
  .##   ## . 
  .#### #  . 
  .  ####  . 
  . # #### . 
  .##   ## . 
  .##   ## . 
  .##  ### . 
  .  ####  . 

Char 57 (nine), width 8
  .  ####  . 
  .##  ### . 
  .##   ## . 
  .##   ## . 
  .##   ## . 
  .### ### . 
  . ### ## . 
  .     ## . 
  .##   ## . 
  .##  ##  . 
  . ####   . 

Char 58 (colon), width 4
  .    . 
  .    . 
  .    . 
  .    . 
  . ## . 
  . ## . 
  . ## . 
  .    . 
  . ## . 
  . ## . 
  . ## . 
