Font: ncenR18 (Latin-1-bdf-sources/ncenR18.bdf)
Declared name: -adobe-new century schoolbook-medium-r-normal--25-180-100-100-p-136-iso10646-1
Declared family: new century schoolbook
Declared weight: medium
Declared size: 25
Characters: 15
Height: 18
Baseline: 18
Max width: 14
Fixed width: False

Char 32 (space), width 7
  .       . 
  .       . 
  .       . 
  .       . 
  .       . 
  .       . 
  .       . 
  .       . 
  .       . 
  .       . 
  .       . 
  .       . 
  .       . 
  .       . 
  .       . 
  .       . 
  .       . 
 __       __

Char 43 (plus), width 14
  .              . 
  .              . 
  .              . 
  .              . 
  .              . 
  .      ##      . 
  .      ##      . 
  .      ##      . 
  .      ##      . 
  .      ##      . 
  . ############ . 
  . ############ . 
  .      ##      . 
  .      ##      . 
  .      ##      . 
  .      ##      . 
  .      ##      . 
 __              __

Char 45 (hyphen), width 8
  .        . 
  .        . 
  .        . 
  .        . 
  .        . 
  .        . 
  .        . 
  .        . 
  .        . 
  .        . 
  . ###### . 
  . ###### . 
  .        . 
  .        . 
  .        . 
  .        . 
  .        . 
 __        __

Char 46 (period), width 7
  .       . 
  .       . 
  .       . 
  .       . 
  .       . 
  .       . 
  .       . 
  .       . 
  .       . 
  .       . 
  .       . 
  .       . 
  .       . 
  .       . 
  .       . 
  .  ###  . 
  .  ###  . 
 __  ###  __

Char 48 (zero), width 13
  .     ###     . 
  .    #   #    . 
  .   ##   ##   . 
  .   #     #   . 
  .  ##     ##  . 
  .  ##     ##  . 
  . ###     ### . 
  . ###     ### . 
  . ###     ### . 
  . ###     ### . 
  . ###     ### . 
  . ###     ### . 
  .  ##     ##  . 
  .  ##     ##  . 
  .   #     #   . 
  .   ##   ##   . 
  .    #   #    . 
 __     ###     __

Char 49 (one), width 13
  .       #     . 
  .     ###     . 
  .   #####     . 
  .      ##     . 
  .      ##     . 
  .      ##     . 
  .      ##     . 
  .      ##     . 
  .      ##     . 
  .      ##     . 
  .      ##     . 
  .      ##     . 
  .      ##     . 
  .      ##     . 
  .      ##     . 
  .      ##     . 
  .      ##     . 
 __   ########  __

Char 50 (two), width 13
  .    #####    . 
  .  ###   ###  . 
  .  #      ##  . 
  . ###     ### . 
  . ###     ### . 
  .  #      ### . 
  .         ##  . 
  .        ###  . 
  .        ##   . 
  .       ##    . 
  .      ##     . 
  .     ##      . 
  .    ##       . 
  .   ##      # . 
  .  ##       # . 
  . ##       ## . 
  . ########### . 
 __ ########### __

Char 51 (three), width 13
  .    #####    . 
  .  ##   ###   . 
  . ##     ###  . 
  . ###    ###  . 
  . ###    ###  . 
  .  #     ##   . 
  .        ##   . 
  .       ##    . 
  .    #####    . 
  .        ##   . 
  .         ##  . 
  .         ### . 
  .  #      ### . 
  . ###     ### . 
  . ###     ##  . 
  . ##     ###  . 
  .  ##    ##   . 
 __    ####     __

Char 52 (four), width 13
  .         #   . 
  .        ##   . 
  .       ###   . 
  .      ####   . 
  .     ## ##   . 
  .    ##  ##   . 
  .    #   ##   . 
  .   ##   ##   . 
  .  ##    ##   . 
  . ##     ##   . 
  . #      ##   . 
  .##      ##   . 
  .#       ##   . 
  .############ . 
  .        ##   . 
  .        ##   . 
  .        ##   . 
 __      ###### __

Char 53 (five), width 13
  .  #########  . 
  .  ########   . 
  .  #          . 
  .  #          . 
  .  #          . 
  .  #          . 
  .  #          . 
  .  # #####    . 
  .  ##   ###   . 
  .         ##  . 
  .         ##  . 
  .         ### . 
  .  ##     ### . 
  . ###     ### . 
  . ###     ##  . 
  .  #      ##  . 
  .  ##    ##   . 
 __    #####    __

Char 54 (six), width 13
  .     #####   . 
  .   ###   ### . 
  .   #     ### . 
  .  ##      ## . 
  .  ##         . 
  .  ##         . 
  . ###         . 
  . ### ####    . 
  . ####   ##   . 
  . ###     ##  . 
  . ###     ##  . 
  . ###     ### . 
  . ###     ### . 
  .  ##     ### . 
  .  ##     ##  . 
  .  ##     ##  . 
  .   ##   ##   . 
 __    #####    __

Char 55 (seven), width 13
  .  ########## . 
  .  ########## . 
  .  #       #  . 
  .  #      ##  . 
  .         #   . 
  .        ##   . 
  .        ##   . 
  .        #    . 
  .       ##    . 
  .       ##    . 
  .       #     . 
  .      ##     . 
  .      ##     . 
  .      ##     . 
  .     ###     . 
  .     ###     . 
  .     ###     . 
 __      #      __

Char 56 (eight), width 13
  .    #####    . 
  .   ##   ##   . 
  .   #     #   . 
  .  ##     ##  . 
  .  ##     ##  . 
  .  ###    ##  . 
  .   ###  ##   . 
  .   ######    . 
  .    #####    . 
  .   ## ####   . 
  .  ##    ###  . 
  . ##      ### . 
  . ##       ## . 
  . ##       ## . 
  . ##       ## . 
  .  ##     ##  . 
  .  ###   ###  . 
 __    #####    __

Char 57 (nine), width 13
  .    #####    . 
  .   ##   ##   . 
  .  ###    ##  . 
  .  ##     ##  . 
  . ###     ### . 
  . ###     ### . 
  . ###     ### . 
  .  ##     ### . 
  .  ###    ### . 
  .   ##   #### . 
  .    #### ### . 
  .         ### . 
  .         ##  . 
  .         ##  . 
  . ##     ###  . 
  . ###    ##   . 
  . ###   ###   . 
 __   #####     __

Char 58 (colon), width 7
  .       . 
  .       . 
  .       . 
  .       . 
  .       . 
  .       . 
  .  ###  . 
  .  ###  . 
  .  ###  . 
  .       . 
  .       . 
  .       . 
  .       . 
  .       . 
  .       . 
  .  ###  . 
  .  ###  . 
 __  ###  __
